Id,Label,timeset,Gender,indegree,outdegree,degree,weighted indegree,weighted outdegree,weighted degree,modularity_class
1,"William I, king of Scots (d.1214)",,M,1,170,171,1,495,496,68
58,"Alexander II, king of Scots (d.1249)",,M,1,156,157,1,397,398,71
360,"Alexander III, king of Scots (d.1286)",,M,1,67,68,1,91,92,67
74,"Malcolm IV, king of Scots (d.1165)",,M,0,50,50,0,126,126,73
130,"David I, king of Scots (d.1153)",,M,0,37,37,0,107,107,73
788,"Andrew Murray, bishop of Moray (d.1242)",,M,7,36,43,12,51,63,69
40,"William Malveisin, bishop of St Andrews (d.1238)",,M,6,28,34,9,59,68,68
2087,"Mael Domnaig, earl of Lennox (d. by 1265)",,M,3,26,29,3,52,55,66
432,"David of Bernham, bishop of St Andrews (d.1253)",,M,0,22,22,0,46,46,72
90,"Henry, earl of Northumberland and Huntingdon (d.1152)",,M,0,21,21,0,28,28,73
2046,"Roger de Quincy, earl of Winchester (d.1264)",,M,2,18,20,2,28,30,9
16,"William Comyn, earl of Buchan (d.1233)",,M,2,17,19,2,21,23,73
451,"Alan, lord of Galloway (d.1234)",,M,2,17,19,2,27,29,71
817,"Roger, bishop of St Andrews (d.1202)",,M,3,17,20,4,31,35,73
134,"Richard, bishop of St Andrews (d.1178)",,M,0,16,16,0,49,49,73
858,"Walter of St Albans, bishop of Glasgow (d.1232)",,M,13,16,29,21,24,45,66
82,Kelso Abbey,,I,186,15,201,366,17,383,72
2220,"Ralph of Lamley, bishop of Aberdeen (d.1247)",,M,2,15,17,4,17,21,71
3786,"Henry of Norham, prior of St Andrews (fl.x1228-1236)",,M,0,15,15,0,22,22,69
148,"Robert, bishop of St Andrews (d.1159)",,M,0,14,14,0,33,33,73
142,"David, earl of Huntingdon (d.1219)",,M,2,13,15,3,31,34,67
400,"Alan Stewart, son of Walter (d.1204)",,M,0,13,13,0,23,23,66
112,Richard de Moreville (d.1189 or 1190),,M,0,12,12,0,23,23,71
782,"Malcolm (I), earl of Fife (d.1229)",,M,5,12,17,6,15,21,73
2081,"John de Vaux, knight (fl.1213-55)",,M,0,12,12,0,15,15,69
745,"Jocelin, bishop of Glasgow (d.1199)",,M,3,11,14,11,25,36,68
751,"Bertram, prior of Durham (d.1212/13)",,M,5,11,16,7,12,19,73
1378,"Walter Stewart (II), son of Alan (d.1241)",,M,3,11,14,3,37,40,71
1382,David of Quixwood,,M,0,11,11,0,36,36,3
2248,"Malise (II), earl of Strathearn (d.1271)",,M,0,11,11,0,17,17,67
444,"Patrick (I), earl of Dunbar (d.1232)",,M,1,10,11,1,39,40,3
453,"Roland (Lachlan), lord of Galloway (d.1200)",,M,0,10,10,0,12,12,75
456,"Gamelin, bishop of St Andrews (d.1271)",,M,0,10,10,0,17,17,73
806,"Saer de Quincy, earl of Winchester (d.1219)",,M,0,10,10,0,20,20,68
1453,James Stewart (d.1309),,M,0,10,10,0,11,11,66
1981,"Alexander Comyn, earl of Buchan (d.1289)",,M,1,10,11,1,11,12,68
12934,"William de Lizars, son of David, lord of Gorton",,M,0,10,10,0,11,11,1
3,"Walter Stewart (I), son of Alan (d.1177)",,M,1,9,10,2,18,20,66
95,"Ada de Warenne (d.1178), countess of Northumberland",,F,0,9,9,0,13,13,73
307,Robert of London (d.1225),,M,3,9,12,4,12,16,68
435,"William of Bondington, bishop of Glasgow (d.1258)",,M,8,9,17,12,11,23,71
445,"Patrick (II), earl of Dunbar (d.1248)",,M,1,9,10,3,19,22,3
446,"Patrick (III), earl of Dunbar (d.1289)",,M,1,9,10,1,18,19,72
891,"William de Vaux, knight (d.1221x38)",,M,1,9,10,1,13,14,69
1317,"John White, prior of St Andrews (d.1258)",,M,2,9,11,2,12,14,73
2006,"Ralph of Greenlaw, abbot of Dunfermline (fl.1275-96)",,M,0,9,9,0,9,9,87
39,"Hugh de Sigillo, bishop of Dunkeld (d.1229 or 1230)",,M,0,8,8,0,14,14,67
85,"Arnold, bishop of St Andrews (d.1162)",,M,2,8,10,2,19,21,73
189,Durham Cathedral Priory,,I,33,8,41,55,9,64,73
850,"John Scott, bishop of Dunkeld (d.1203)",,M,1,8,9,2,12,14,74
1938,"Robert Bruce V, lord of Annandale (d.1295)",,M,9,8,17,9,10,19,67
1971,Alan Durward (d.1275),,M,1,8,9,1,14,15,74
2009,"John of Haddington, prior of St Andrews (d.1304)",,M,1,8,9,1,10,11,9
2032,"Richard of Inverkeithing, bishop of Dunkeld (d.1272)",,M,1,8,9,1,12,13,73
4712,"Ralph Kerneth, prior of Durham (d.1234)",,M,0,8,8,0,8,8,0
5370,"Richard of Claxton, prior of Durham (fl.1272-85)",,M,0,8,8,0,8,8,69
89,"John, abbot of Kelso (d.1180)",,M,2,7,9,2,8,10,69
171,Thomas Durward (d.1228x33),,M,0,7,7,0,9,9,68
310,William de Moreville (d.1196),,M,0,7,7,0,13,13,71
449,"William Fraser, bishop of St Andrews (d.1297)",,M,0,7,7,0,10,10,9
484,"Hugh, bishop of St Andrews (d.1188)",,M,0,7,7,0,18,18,73
500,"Osbert, abbot of Kelso (d.1203)",,M,1,7,8,1,7,8,77
781,"Richard of Lincoln, bishop of Moray (d.1203)",,M,1,7,8,8,9,17,68
1215,"Simon, prior of St Andrews (fl.1212-25)",,M,0,7,7,0,7,7,92
1433,Edward of Restalrig,,M,0,7,7,0,7,7,3
2110,"William of Brechin, knight",,M,0,7,7,0,10,10,74
2142,"Malcolm (I), earl of Lennox",,M,6,7,13,8,13,21,66
3231,Chapter of Dunkeld,,I,0,7,7,0,12,12,73
4427,"William, son of Earl Patrick (I) (d.1253)",,M,1,7,8,1,13,14,3
11582,"Robert of Lyne, son of David",,M,0,7,7,0,9,9,1
2,"Matthew, bishop of Aberdeen (d.1199)",,M,1,6,7,3,10,13,73
124,"Cospatric, earl of Dunbar (d.1166)",,M,0,6,6,0,13,13,72
170,Robert Bruce II (d.1194),,M,3,6,9,3,6,9,75
749,"Abraham, bishop of Dunblane (fl.1210x14-1220x25)",,M,0,6,6,0,7,7,67
760,"Brice Douglas, bishop of Moray (d.1222)",,M,5,6,11,7,10,17,68
1477,"Ragnvald, king of the Isles (d.1229)",,M,0,6,6,0,6,6,9
2067,"Gilbert Hay (I), lord of Errol (d.1263) (son of David)",,M,5,6,11,5,9,14,67
2274,"William, bishop of Dunblane (d.1291x)",,M,0,6,6,0,6,6,92
4467,John Bisset,,M,3,6,9,4,10,14,69
4681,"Affrica, daughter of Edgar, son of Donald",,F,1,6,7,1,7,8,71
6,"Walter Barclay, chamberlain (d.c.1193)",,M,2,5,7,3,5,8,68
7,Dunfermline Abbey (fd.1128),,I,71,5,76,160,5,165,73
59,"Gregory, bishop of Brechin (fl.1189x98-1242x46)",,M,1,5,6,3,10,13,68
66,"David Hay, lord of Errol (d.1237x41)",,M,2,5,7,5,6,11,71
75,Melrose Abbey (fd.1136),,I,158,5,163,339,5,344,71
131,St Andrews Cathedral Priory,,I,101,5,106,251,7,258,73
140,"Herbert, bishop of Glasgow (d.1164)",,M,4,5,9,4,8,12,72
197,William Lindsay (II) (d.c.1205),,M,0,5,5,0,6,6,9
204,"Waltheof, earl of Dunbar (d.1182)",,M,0,5,5,0,10,10,72
240,"Uhtred, lord of Galloway (d.1174)",,M,0,5,5,0,7,7,68
249,"Edgar, king of Scots (d.1107)",,M,0,5,5,0,12,12,3
260,"Gilbert or Gilla Brigte, earl of Strathearn (d.1223)",,M,1,5,6,4,24,28,67
448,"Florence, bishop-elect of Glasgow (d.1210)",,M,1,5,6,1,9,10,71
468,"Gilbert, bishop of Dunkeld (d.1236)",,M,0,5,5,0,8,8,73
494,"Simon de Liberatione, bishop of Dunblane (fl.1173x77-c.1195)",,M,0,5,5,0,6,6,68
754,William Bruce (d.1211/12),,M,1,5,6,1,7,8,71
798,"Richard de Prebenda, bishop of Dunkeld (d.1210)",,M,0,5,5,0,6,6,74
970,"Walter of Lundin, son of Philip the chamberlain",,M,1,5,6,1,6,7,73
1092,"Gregory Melville (II), son of William",,M,0,5,5,0,6,6,73
1285,"Walter Oliphant, justiciar of Lothian (son of Walter) (d.1242)",,M,0,5,5,0,5,5,3
1358,Alexander Stewart of Dundonald (d.1282),,M,0,5,5,0,14,14,66
1720,Chapter of Glasgow,,I,1,5,6,1,6,7,66
1857,"Robert Bruce IV, lord of Annandale (d.1226x33)",,M,4,5,9,4,5,9,67
1899,"John, earl of Huntingdon and Chester (d.1237)",,M,0,5,5,0,12,12,67
2176,"John Comyn, lord of Badenoch (d.1302)",,M,0,5,5,0,10,10,69
2208,"Reginald Cheyne, father (d.c.1293)",,M,1,5,6,1,6,7,68
2362,Adam Malherbe of Morham,,M,0,5,5,0,7,7,1
3067,"Richard of Leicester, burgess of Perth",,M,0,5,5,0,7,7,73
3398,"James, legate (fl.1220-21)",,M,0,5,5,0,7,7,9
3505,"Robert, earl of Strathearn (1223-45)",,M,0,5,5,0,13,13,67
4083,"John of Methil, son of Michael the clerk",,M,0,5,5,0,8,8,71
5312,Adam of Little Reston,,M,1,5,6,1,6,7,3
8515,John of Inchyra (son of Duncan),,M,0,5,5,0,5,5,67
10677,"Elizabeth Bisset, wife of Andrew del Bois",,F,0,5,5,0,7,7,69
11785,"Gregory, marischal of Coldingham",,M,0,5,5,0,5,5,3
13595,"Robert of London, son of Richard of London",,M,0,5,5,0,7,7,9
14974,"Eve Murdoch, lady of Rothes",,F,0,5,5,0,5,5,69
14,Robert de Quincy (d.1200),,M,0,4,4,0,5,5,68
15,"Philip de Valognes, chamberlain (d.1215)",,M,0,4,4,0,4,4,74
144,Gilbert de Umfraville (fl.c.1140-90),,M,0,4,4,0,5,5,72
238,"Malcolm, earl of Atholl (d.c.1197)",,M,0,4,4,0,4,4,73
275,"Alexander de St Martin, sheriff",,M,2,4,6,2,4,6,73
331,"Godred, king of the Isles (d.1187)",,M,0,4,4,0,4,4,75
420,"Archibald, bishop of Moray (d.1298)",,M,7,4,11,9,6,15,69
755,"Fergus, earl of Buchan (d.x1214)",,M,0,4,4,0,4,4,68
772,"Henry, abbot of Kelso (d.1218)",,M,1,4,5,1,4,5,66
809,"Ralph, bishop of Brechin  (d.1212x14)",,M,0,4,4,0,16,16,68
818,"Roger, prior of Paisley (fl.1195x96-1208x14)",,M,0,4,4,0,4,4,66
899,Everard of Pencaitland,,M,0,4,4,0,4,4,73
916,"Alexander, son of William, sheriff of Stirling",,M,0,4,4,0,5,5,66
940,"Richard Melville, son of Gregory",,M,2,4,6,5,4,9,68
1043,Eschina of Mow/London,,F,0,4,4,0,9,9,72
1199,"Ralph, son of Ealhweald ",,M,0,4,4,0,8,8,3
1204,"Gilbert of Stirling, bishop of Aberdeen (d.1239)",,M,0,4,4,0,8,8,68
1309,"Edgar, son of Donald",,M,0,4,4,0,5,5,72
1419,John Balliol (d.1268),,M,2,4,6,2,5,7,9
1508,"Olaf II, king of the Isles (d.1237)",,M,0,4,4,0,4,4,9
1695,"Walter Murray of Petty (son of William (II) Freskin Murray, d.1226)",,M,1,4,5,5,4,9,69
2039,"Geoffrey de Liberatione, bishop of Dunkeld (d.1249)",,M,1,4,5,1,4,5,71
2041,"William, earl of Mar (d.a.1281)",,M,1,4,5,1,4,5,67
2050,"Malise (III), earl of Strathearn (d.in or a.1317)",,M,0,4,4,0,6,6,67
2116,"John of Denmuir, knight",,M,2,4,6,2,5,7,74
2201,"Herbert Maxwell, son of Aymer Maxwell",,M,3,4,7,3,5,8,66
2258,"Alexander de Vaux, knight",,M,0,4,4,0,8,8,9
2562,"Nicholas, bishop of the Isles (Koli or Meaux)",,M,0,4,4,0,4,4,9
3127,"Malcolm, earl of Fife (I or II)",,M,0,4,4,0,5,5,99
3497,"Fergus, son of Gilbert, earl of Strathearn (d.c.1247)",,M,0,4,4,0,7,7,67
3531,"Herbert Maunsel, abbot of Kelso (fl.1221-39)",,M,1,4,5,1,4,5,71
3671,Bertram of Little Reston (son of Adam of Little Reston),,M,0,4,4,0,9,9,3
4589,"Alwine (II), earl of Lennox",,M,0,4,4,0,4,4,66
5648,"Conan / Cumming, son of  Earl Henry of Atholl",,M,0,4,4,0,4,4,67
6729,"Ralph Noble, father",,M,0,4,4,0,4,4,66
6771,"Thomas of Restalrig, sheriff of Edinburgh",,M,1,4,5,1,4,5,73
7026,Brice of Ardrossan,,M,0,4,4,0,10,10,69
7984,"John, son of Bertram, Lord of Little Reston ",,M,3,4,7,3,11,14,3
8146,Elias Chaunum of Ayton,,M,0,4,4,0,5,5,3
8911,"Muriel of Pollok, lady of Rothes",,F,0,4,4,0,5,5,69
10728,John Brack,,M,0,4,4,0,4,4,9
11693,"Mabel, daughter of Constantine of Coldingham ",,F,0,4,4,0,5,5,3
64,"Henry of Stirling, son of Earl David",,M,1,3,4,1,3,4,74
65,"Henry of Brechin, son of Earl David (d.c.1245)",,M,0,3,3,0,3,3,69
135,Walter Lindsay (II) (d.c.1165),,M,0,3,3,0,3,3,9
143,"Ingram, bishop of Glasgow (d.1174)",,M,2,3,5,2,3,5,68
256,"Walter, prior of St Andrews (fl.1160-1198x99)",,M,1,3,4,1,3,4,68
265,"Alexander I, king of Scots (d.1124)",,M,0,3,3,0,4,4,73
406,"Alan, bishop of Argyll (d.1262)",,M,0,3,3,0,5,5,66
443,"Cospatric, earl of Dunbar (d.1138)",,M,0,3,3,0,3,3,3
454,"Thomas of Galloway, earl of Atholl (d.1231)",,M,0,3,3,0,5,5,74
481,"Herbert, dean of Glasgow (fl.1179x89-1204x07)",,M,0,3,3,0,3,3,69
488,"John, bishop of Aberdeen (d.1207)",,M,0,3,3,0,6,6,68
491,"Jonathan, bishop of Dunblane (d.1209/10)",,M,0,3,3,0,3,3,68
493,"John of Leicester, bishop of Dunkeld (d.1214)",,M,0,3,3,0,4,4,68
504,"Richard, bishop of Dunkeld (d.1178)",,M,0,3,3,0,3,3,68
699,"Geoffrey de Percy, son of Alan",,M,0,3,3,0,4,4,9
780,"Adam of Calder, bishop of Aberdeen (d.1228)",,M,0,3,3,0,6,6,73
789,"Gilbert Murray, bishop of Caithness (d.1245)",,M,3,3,6,3,3,6,78
837,"Thomas, prior of St Andrews (fl.1199-1211)",,M,0,3,3,0,5,5,73
902,William Maule (12C),,M,0,3,3,0,6,6,72
1080,William de Heriz,,M,0,3,3,0,3,3,75
1106,Philip de Mowbray,,M,1,3,4,1,5,6,73
1135,"David de Bonville, marischal (fl.late 12C-mid13C)",,M,0,3,3,0,3,3,72
1209,Edward of Oldcambus,,M,1,3,4,1,4,5,73
1220,Helen de Moreville (d.1217),,F,1,3,4,1,3,4,9
1357,"Walter Comyn, earl of Menteith (d.1258)",,M,1,3,4,1,4,5,69
1366,"John de Montfort, son of William",,M,0,3,3,0,3,3,1
1587,"William II, king of England (d.1100)",,M,0,3,3,0,3,3,3
1747,Reginald de Warenne (d.a.1247),,M,0,3,3,0,5,5,67
1764,Peter Graham,,M,0,3,3,0,3,3,70
1770,Hugh Balliol (d.1229),,M,0,3,3,0,4,4,72
1849,John of Wilton,,M,0,3,3,0,3,3,66
1951,"William, son of Geoffrey, lord of Ord",,M,0,3,3,0,3,3,66
1995,"Eustace Balliol, lord of Tours (d.a.1276)",,M,0,3,3,0,4,4,68
2023,"Henry, bishop of Whithorn (d.1293)",,M,1,3,4,1,4,5,9
2056,"William Wishart, bishop of St Andrews (d.1279)",,M,3,3,6,3,3,6,67
2077,"Simon of Kinnear (III), son of Simon",,M,0,3,3,0,3,3,73
2114,Roger de Mowbray,,M,0,3,3,0,4,4,74
2119,"John Comyn, lord of Badenoch (d.1277)",,M,0,3,3,0,3,3,67
2135,"Duncan, earl of Carrick (d.1250)",,M,0,3,3,0,11,11,71
2137,"Gilbert de Umfraville, earl of Angus (d.1307)",,M,0,3,3,0,3,3,92
2151,"Walter Stewart, earl of Menteith (d.c.1293)",,M,0,3,3,0,3,3,92
2153,"Mary, wife of John of the Wardrobe",,F,0,3,3,0,5,5,66
2158,John of the Wardrobe,,M,0,3,3,0,5,5,66
2186,"Simon, abbot of Dunfermline (fl.1267-75)",,M,0,3,3,0,4,4,93
2209,"Donald, earl of Mar (d.1297x1305)",,M,0,3,3,0,3,3,67
2211,Chapter of Aberdeen,,I,0,3,3,0,3,3,86
2223,"Roger Avenel, sheriff (d.1243)",,M,0,3,3,0,3,3,71
2231,"Robert of Leicester/Craigie, dean of Aberdeen (d.1277x88)",,M,0,3,3,0,3,3,86
2247,"David of Strathbogie, earl of Atholl (d.1270)",,M,1,3,4,1,3,4,69
2321,"Nigellus (Niall), earl of Carrick",,M,0,3,3,0,3,3,66
2361,"Robert de Stuteville, bishop of Dunkeld (d.1282x83)",,M,0,3,3,0,4,4,73
2394,"Robert of Holy Island, bishop of Durham (d.1283)",,M,0,3,3,0,3,3,3
3234,"Walter, abbot of Arbroath (fl.1247-58x)",,M,0,3,3,0,3,3,74
3349,"Thomas, abbot of Lindores (d.1273)",,M,2,3,5,2,3,5,67
3370,"Richard of Fans (early 13C, father of Adam)",,M,0,3,3,0,3,3,72
3417,"Adam, son of Abraham of Lour /Nevay",,M,0,3,3,0,4,4,74
3427,"Adam of Kilconquhar, earl of Carrick (d.1271)",,M,0,3,3,0,4,4,73
3561,"William, abbot of Paisley (fl.1225/26-1266)",,M,4,3,7,4,3,7,66
3645,David of Paxton,,M,0,3,3,0,5,5,3
3666,"Patrick, son of Colman",,M,1,3,4,1,3,4,3
3714,"Patrick (I or II), earl of Dunbar",,M,0,3,3,0,3,3,72
3784,"Thomas of Melsonby, prior of Durham (fl.1229-44)",,M,1,3,4,1,3,4,73
4040,Laurence Abernethy (fl.1180sx1230s),,M,3,3,6,5,3,8,71
4401,"Thomas, prior of Coldingham (fl.1212-22x29)",,M,0,3,3,0,3,3,3
4435,Alexander Seton (mid13C),,M,0,3,3,0,3,3,73
4438,John de Normanville (d.1240),,M,0,3,3,0,9,9,71
4520,"Thomas, son of David of Quixwood",,M,0,3,3,0,7,7,3
4532,"Otto de Tonengo, papal legate (d.1250/1)",,M,0,3,3,0,3,3,66
4640,"Margaret of Ceres, wife of Michael Scott",,F,0,3,3,0,5,5,73
4664,"Malcolm, son of Earl Mael Domnaig of Lennox (d.c.1248)",,M,0,3,3,0,3,3,66
5390,Robert Lavird of Auchencrow,,M,0,3,3,0,3,3,3
5611,"Adam, son of Eadwulf",,M,0,3,3,0,4,4,1
5777,"William, son of Patrick, son of Cospatric",,M,0,3,3,0,12,12,72
6096,Ness of London (d.1232/3),,M,0,3,3,0,4,4,1
6518,"Helen, daughter of Alan of Galloway, wife of Roger de Quincy",,F,0,3,3,0,5,5,66
6773,"Thomas of Lundin, son of Walter, sheriff of Fife (fl.1200x27)",,M,0,3,3,0,4,4,73
7387,"William, earl of Ross (d.1274)",,M,0,3,3,0,7,7,69
7957,"Robert, son of Reginald of Great Reston",,M,0,3,3,0,6,6,3
8148,Robert of Prenderguest,,M,0,3,3,0,4,4,3
8339,"Hugh of Nydie (II), puer of Bishop Malveisin",,M,0,3,3,0,4,4,73
8392,"John Gray of Ayton, mayor of Berwick",,M,0,3,3,0,3,3,69
8440,Thomas of Thirlestane (d.1228),,M,0,3,3,0,3,3,9
8778,"Walter de Bolbec, younger",,M,0,3,3,0,6,6,69
9218,David of Inverlunan,,M,0,3,3,0,3,3,69
9285,"William Bisset (early 13C), brother of John",,M,1,3,4,1,3,4,69
9354,Fergus of Ardrossan (13C),,M,0,3,3,0,3,3,69
10319,"Scholastica, daughter of Merleswain of Ardross",,F,0,3,3,0,3,3,73
10322,"John Avenel, son of Gervase Avenel",,M,1,3,4,1,3,4,73
10450,"Roger, son of Baldric ",,M,0,3,3,0,5,5,74
10676,Andrew del Bois,,M,0,3,3,0,4,4,69
10730,Elias of Brotherstone,,M,0,3,3,0,6,6,9
10739,Thomas of Brotherstone,,M,0,3,3,0,6,6,9
10899,"David de Lizars, lord of Gorton",,M,0,3,3,0,3,3,1
11150,"John, son of Eilaf of Elliston ",,M,0,3,3,0,4,4,9
11174,Ralph Nanus (le Nain),,M,0,3,3,0,3,3,66
11805,Stephen Stampard,,M,0,3,3,0,3,3,3
11881,"John Condam, swineherd of Coldingham ",,M,0,3,3,0,3,3,3
11988,"Simon Cornet, son of John Cornet",,M,0,3,3,0,3,3,66
12072,"Solomon Frebern of Lamberton ",,M,0,3,3,0,3,3,3
12112,John of Howburn,,M,0,3,3,0,6,6,3
12176,Richard of Prenderguest,,M,0,3,3,0,3,3,3
12233,"Nicholas, son of Thomas of Oldcambus ",,M,0,3,3,0,3,3,3
12356,"Patrick, son of  Waltheof of Prenderguest",,M,1,3,4,1,3,4,3
12576,"Adam, marischal, son of Patrick, marischal (BWK)",,M,0,3,3,0,3,3,3
13304,"Avice, daughter of John son of Eilaf of Elliston",,F,0,3,3,0,3,3,69
13376,"Petronilla, daughter of Adam Herring of Minto",,F,0,3,3,0,4,4,69
14132,Ada Cantor (daughter of Adam of Little Reston),,F,0,3,3,0,3,3,3
14534,"Alan, son of Alan son of Cospatric of Swinton ",,M,2,3,5,2,3,5,3
15055,John Sinclair of Herdmanston,,M,0,3,3,0,3,3,9
15167,John Burgulum of Saltoun,,M,0,3,3,0,3,3,9
15359,"Alexander, lord of Stirling",,M,0,3,3,0,3,3,66
15530,"Ewen, son of Amabel daughter of Samuel, rector of Stobo ",,M,0,3,3,0,3,3,66
15743,"Constantine of Lochore (I), son of Robert of Bourguignon",,M,0,3,3,0,3,3,69
16960,"Malcolm (I) or (II), earl of Lennox",,M,0,3,3,0,3,3,2
13,"Duncan (II), earl of Fife (d.1204)",,M,1,2,3,1,8,9,73
24,"William Hay (I), lord of Errol (d.c.1201)",,M,1,2,3,2,2,4,68
33,Ranulf Soulis (d.1207),,M,0,2,2,0,2,2,73
37,Walter Murdoch,,M,0,2,2,0,2,2,69
41,Arbroath Abbey (fd.1178),,I,102,2,104,263,2,265,68
56,"Ermengarde de Beaumont, queen of Scots (d.1233)",,F,1,2,3,1,2,3,69
57,Adam of Stawell,,M,0,2,2,0,2,2,69
62,Ingram Balliol (d.1239x44),,M,1,2,3,1,2,3,75
77,Coldingham Priory (fd.1139),,I,116,2,118,199,2,201,3
79,Hugh de Moreville (I) (d.1162),,M,0,2,2,0,2,2,9
114,Richard Comyn (d.c.1179),,M,0,2,2,0,3,3,72
149,"Gregory, bishop of Dunkeld (d.1169)",,M,0,2,2,0,2,2,73
154,"Robert Avenel, lord of Eskdale (d.1185)",,M,0,2,2,0,4,4,71
155,William de Vieuxpont (II) (d.c.1203),,M,1,2,3,2,4,6,72
160,"Robert de Chesney, bishop of Lincoln (d.1166)",,M,0,2,2,0,2,2,9
172,"Ranulf Soulis, king's butler (d.1165x72)",,M,0,2,2,0,3,3,73
176,David Uvieth,,M,0,2,2,0,4,4,74
177,"Walter de Bolbec, elder",,M,0,2,2,0,2,2,69
191,"John, bishop of Glasgow (d.1147)",,M,0,2,2,0,2,2,75
297,Philip de Vermelles (father of Philip and Ralph),,M,0,2,2,0,2,2,68
354,May Priory,,I,16,2,18,35,2,37,73
356,"Adam, abbot of Arbroath (fl.1240-46)",,M,0,2,2,0,2,2,68
407,"Albin, bishop of Brechin (d.1269)",,M,0,2,2,0,3,3,67
419,"Archibald, abbot of Dunfermline (d.1198)",,M,0,2,2,0,4,4,73
425,"Henry, earl of Atholl (d.x1211)",,M,0,2,2,0,2,2,73
439,"John of Cheam, bishop of Glasgow (d.1268)",,M,3,2,5,4,3,7,66
466,"Gilbert, archdeacon of Dunblane (fl.1203x10-1235x39)",,M,0,2,2,0,2,2,67
478,"Henry, abbot of Arbroath (fl.1179-1207)",,M,2,2,4,3,2,5,69
490,"John, bishop of Whithorn (d.1209)",,M,0,2,2,0,3,3,9
496,"Harald Maddadson, earl of Orkney and Caithness (d.1206)",,M,0,2,2,0,2,2,69
575,William of Lamberton (father of William),,M,0,2,2,0,2,2,71
756,"Richard de Cane, abbot of Kelso (d.1208)",,M,0,2,2,0,2,2,77
784,"Duncan, earl of Mar (d.1242x44)",,M,1,2,3,1,2,3,86
785,"Gilchrist, earl of Mar",,M,1,2,3,1,2,3,68
791,"Hugh de Mortimer, dean of Glasgow (d.1235/6)",,M,0,2,2,0,2,2,75
803,"Patrick, abbot of Dunfermline  (fl.1202-17x1223)",,M,0,2,2,0,2,2,80
815,"Robert, bishop of Ross (d.1249)",,M,1,2,3,1,2,3,69
835,"Laurence of Thornton, archdeacon of St Andrews (d.1238x40)",,M,1,2,3,1,2,3,73
841,"Malise, son of Ferteth earl of Strathearn (d.a.1214)",,M,1,2,3,1,3,4,67
874,"Peter of Pollok, son of Fulbert",,M,0,2,2,0,5,5,66
880,"Bernard of Hadden, sheriff of Roxburgh",,M,2,2,4,2,4,6,72
935,Robert of Kent,,M,1,2,3,1,4,5,72
965,"Thomas Colville 'Scot', lord of Keresban (d.1219)",,M,0,2,2,0,3,3,1
995,"Duncan I or II, earl of Fife",,M,0,2,2,0,2,2,73
1044,Simon Fraser (TRW),,M,0,2,2,0,2,2,72
1053,Ralph de Clare,,M,1,2,3,1,3,4,72
1057,Anselm of Mow/Whitton,,M,1,2,3,2,8,10,72
1058,Richard of Lincoln (Senior),,M,1,2,3,1,6,7,72
1162,William de Vieuxpont (I) (d.1165x70),,M,0,2,2,0,4,4,3
1195,"Eve, wife of William Hay, lord of Errol",,F,1,2,3,1,2,3,68
1231,Philip Colville,,M,0,2,2,0,2,2,9
1239,Eustace de Vescy (d.1216),,M,0,2,2,0,3,3,72
1268,Richard of Kinnaird,,M,0,2,2,0,2,2,74
1292,Henry de Mandeville (Mandell),,M,0,2,2,0,3,3,9
1318,Thomas Hay (son of William),,M,0,2,2,0,2,2,70
1330,"Malcolm Hay, king's butler",,M,0,2,2,0,2,2,73
1335,"Waltheof, son of Cospatric, lord of Dalmeny and Inverkeithing",,M,0,2,2,0,2,2,73
1365,"Margery, countess of Buchan (d.c.1244)",,F,0,2,2,0,5,5,73
1389,"John Hay (I), lord of Naughton (d.xOct.1266)",,M,0,2,2,0,2,2,74
1436,Patrick of Ryedale (son of Ansketill),,M,1,2,3,1,9,10,71
1513,"Harald, king of the Isles (d.1248)",,M,0,2,2,0,2,2,9
1522,"Magnus, king of the Isles (d.1265)",,M,0,2,2,0,3,3,75
1617,"Thor, the Long",,M,0,2,2,0,2,2,3
1663,Whithorn Cathedral Priory,,I,8,2,10,8,6,14,9
1858,John Gifford (son of William son of Hugh),,M,0,2,2,0,2,2,74
1892,Simon Mauleverer,,M,0,2,2,0,2,2,72
1935,"Alexander, son of King Alexander III (d.1284)",,M,0,2,2,0,2,2,9
1956,Dervorguilla Balliol (d.1290),,F,1,2,3,2,3,5,9
1982,"Clement, bishop of Dunblane (d.1258)",,M,0,2,2,0,2,2,67
1983,"Henry Cheyne, bishop of Aberdeen (d.1328x29)",,M,0,2,2,0,2,2,68
2026,"Robert Hertford, precentor of Glasgow (fl.1223x25-1228)",,M,2,2,4,3,2,5,66
2030,"Hugh, abbot of Kelso (d.1248)",,M,2,2,4,2,2,4,71
2031,"Innocent, abbot of Inchaffray (fl.1221-35)",,M,2,2,4,2,2,4,67
2063,"Hugh Abernethy, knight (d. 1291x2)",,M,5,2,7,5,2,7,74
2066,"Richenda, daughter of Humphrey Barclay",,F,1,2,3,1,9,10,68
2072,"Richard Marsh, bishop of Durham (d.1226)",,M,1,2,3,1,3,4,72
2083,Simon (II) of Kinnear,,M,0,2,2,0,8,8,71
2094,"William Mowat, knight, sheriff (son of Michael)",,M,0,2,2,0,2,2,90
2121,Henry Hastings (d.1269),,M,0,2,2,0,2,2,71
2129,"Malcolm (II), earl of Fife (d.1266)",,M,0,2,2,0,2,2,71
2130,"Isabel de Valognes, lady of Kilbride",,F,0,2,2,0,2,2,66
2154,"Helen, wife of Bernard of Airth",,F,0,2,2,0,3,3,66
2157,"Dougal, brother of Earl Mael Domnaig of Lennox",,M,1,2,3,1,4,5,66
2160,Bernard of Airth,,M,0,2,2,0,3,3,66
2202,William of Conisbrough (son of William),,M,0,2,2,0,2,2,66
2244,"Henry, son of Adam of Lour / Nevay",,M,0,2,2,0,2,2,74
2257,Alexander Balliol of Cavers (d.c.1311),,M,1,2,3,1,2,3,9
2259,William de Valognes (TRA3) (son of William),,M,0,2,2,0,2,2,73
2264,"Alexander Murray, knight (son of Richard)",,M,0,2,2,0,4,4,73
2276,"Malcolm Murray, knight",,M,0,2,2,0,3,3,73
2278,"Ranulf of Strachan, knight",,M,0,2,2,0,2,2,95
2319,"Robert of Smailholm, abbot of Kelso (d.1258)",,M,0,2,2,0,2,2,73
2324,"Hugh Gifford, son of John Gifford",,M,2,2,4,2,2,4,1
2357,"John of Strathbogie, earl of Atholl (d.1306)",,M,0,2,2,0,2,2,96
2360,"Gilbert of Ruthven, lord of Ruthven in Strathearn",,M,0,2,2,0,3,3,1
2401,"Richard of Bickerton, knight",,M,1,2,3,1,2,3,1
2418,"Hugh of Wells, bishop of Lincoln (d.1235)",,M,0,2,2,0,2,2,68
2419,"Walter Gray, archbishop of York (d.1255)",,M,0,2,2,0,2,2,9
2421,"Osbert, bishop of Dunblane (d.1231)",,M,0,2,2,0,2,2,68
2424,"Simon, bishop of the Isles (d.1248)",,M,0,2,2,0,2,2,9
2425,"Mark, bishop of the Isles (d.1303)",,M,0,2,2,0,2,2,9
2450,"Bertram of Middleton, prior of Durham (fl.1244-58)",,M,0,2,2,0,2,2,3
2500,Chapter of Durham Cathedral,,I,0,2,2,0,2,2,97
2508,Chapter of St Andrews,,I,0,2,2,0,2,2,9
2578,"William of Scremerston, knight",,M,1,2,3,1,2,3,3
2580,Eustace of Newbiggin,,M,0,2,2,0,3,3,3
2993,"Constantine of Lochore (II), son of Philip",,M,0,2,2,0,2,2,73
3008,John Montgomery,,M,0,2,2,0,3,3,71
3100,"David of Lyne, son of Robert (father of Robert)",,M,0,2,2,0,2,2,1
3272,Laurence Avenel,,M,0,2,2,0,3,3,66
3277,"Richard, dean of Kyle (fl.1276)",,M,0,2,2,0,2,2,66
3290,Chapter of Moray,,I,3,2,5,3,3,6,69
3291,"Reginald Cheyne, younger, lord of Duffus",,M,1,2,3,1,2,3,69
3350,"Adam of Makerstoun, master, provost (d.1280x86)",,M,0,2,2,0,2,2,67
3366,"Patrick Corbet, lord of Fogo",,M,0,2,2,0,3,3,71
3462,"John Clerk, son of Matthew the lorimer of Perth",,M,0,2,2,0,2,2,67
3466,"William de Munfichet (Muschet), sheriff of Perth (13C)",,M,0,2,2,0,3,3,74
3486,Chapter of Dunblane,,I,0,2,2,0,2,2,68
3487,"John Fraser of Glenholm, clerk",,M,0,2,2,0,2,2,73
3493,"Robert, deacon, son of Hugh",,M,0,2,2,0,2,2,9
3521,"Adam de Prebenda, dean of Dunkeld (fl.1229x36-45)",,M,0,2,2,0,4,4,73
3526,"W., dean of Dunblane (fl.1239-40)",,M,0,2,2,0,2,2,68
3550,John Moneypenny,,M,3,2,5,3,2,5,9
3581,Adam of Ness,,M,0,2,2,0,2,2,69
3644,"Walter, son of Robert, persona of Ednam",,M,1,2,3,1,2,3,73
3669,"Guy, chaplain",,M,0,2,2,0,2,2,69
3675,"Adam, son of Henry of Prenderguest (I)",,M,0,2,2,0,2,2,3
3766,Clergy of Dunblane,,M,0,2,2,0,2,2,67
3771,"Peter, abbot of Cambuskenneth  (fl.1235-40)",,M,0,2,2,0,2,2,67
4001,Hugh of Biggar,,M,0,2,2,0,2,2,66
4251,Robert Fyndoc,,M,1,2,3,1,2,3,69
4284,"David Lindsay (II), son of David (I), lord of Luffness (d.1241)",,M,0,2,2,0,7,7,1
4384,William de Vescy (II) (d.1253),,M,0,2,2,0,4,4,71
4393,"Avice of Lancaster, wife of Richard de Moreville (d.1191)",,F,0,2,2,0,5,5,9
4425,"William Lindsay (IV), son of Walter (III) (d.c.1247)",,M,0,2,2,0,2,2,73
4437,Roger Burnard (mid13C),,M,0,2,2,0,3,3,71
4458,Ranulf/Ralph of Bunkle,,M,1,2,3,1,3,4,3
4460,"Ness, master, king's physician",,M,1,2,3,1,2,3,74
4464,Simon Crook (son of Robert),,M,1,2,3,1,2,3,66
4466,"Malcolm, earl of Angus (d.1236x42)",,M,0,2,2,0,4,4,68
4526,"William, son of Robert of Scremerston",,M,0,2,2,0,2,2,3
4564,"William Colville, son of Thomas Colville",,M,1,2,3,1,2,3,1
4579,"David, lord of Strathbogie, son of Earl Duncan (II) ",,M,0,2,2,0,2,2,69
4585,Richard de Bataille,,M,0,2,2,0,2,2,74
4618,"Galiena, wife of Philip de Mowbray",,F,1,2,3,1,4,5,73
4620,"Margaret, daughter of William I, wife of Eustace de Vescy",,F,1,2,3,1,4,5,71
4625,Malcolm Lockhart (12C/13C),,M,0,2,2,0,2,2,66
4636,Waleran de Normanville (d.1253),,M,2,2,4,2,2,4,71
4709,"William Prat, sheriff of Aberdeen",,M,0,2,2,0,2,2,73
4752,"William de Forz, count of Aumale (d.1260)",,M,0,2,2,0,2,2,66
4923,"R., abbot of Dunfermline (unknown)",,M,0,2,2,0,2,2,4
4959,"Robert, abbot of Dunfermline (either of Keldeleth or of Crail)",,M,0,2,2,0,2,2,5
4987,"Michael, prior of Guisborough",,M,0,2,2,0,3,3,66
5050,"John (II) of Morham, son of John Malherbe (I)",,M,0,2,2,0,3,3,68
5051,Gilbert de St Martin of Bara,,M,0,2,2,0,2,2,66
5136,"Hugh, abbot of Culross (d.1245)",,M,0,2,2,0,2,2,67
5267,"Gilbert of Fintray, burgess of Aberdeen",,M,0,2,2,0,2,2,69
5338,"Simon, son of Thomas",,M,4,2,6,4,3,7,3
5375,"Adam, son of Adam of Edington, knight",,M,0,2,2,0,2,2,3
5386,"John, master of nuns of St Bothans",,M,0,2,2,0,2,2,3
5393,"Robert of Bernham, mayor of Berwick",,M,0,2,2,0,2,2,71
5557,"Matilda, countess of Angus",,F,0,2,2,0,4,4,68
5601,"Isabel, countess of Atholl",,F,0,2,2,0,4,4,74
5625,Ralph Maule,,M,0,2,2,0,2,2,1
5634,"Simon Lindsay, knight (mid 13C)",,M,1,2,3,1,2,3,72
5721,David of Inchyra,,M,0,2,2,0,2,2,67
5791,Thomas Gordon,,M,0,2,2,0,4,4,72
5798,"Ness, son of Ness of Waughton",,M,0,2,2,0,3,3,1
5803,"Adam of Fans, son of Richard",,M,0,2,2,0,2,2,9
5865,"Margery, countess of Carrick",,F,0,2,2,0,2,2,71
5874,"Patrick (IV), earl of Dunbar/March (d.1308)",,M,0,2,2,0,4,4,72
5902,"Gilbert, son of Aldan",,M,0,2,2,0,3,3,72
5922,"Richard of Lennel, son of Norman",,M,0,2,2,0,2,2,69
5948,"Alan, son of Thomas of Darnchester",,M,0,2,2,0,2,2,72
5967,Philip of Halliburton,,M,0,2,2,0,7,7,72
6175,Richard Gordon,,M,0,2,2,0,2,2,72
6398,"Guy de Normanville, knight",,M,1,2,3,1,3,4,71
6465,"Roger Maule ",,M,0,2,2,0,2,2,75
6470,"Henry, son of Samson of Longcroft",,M,0,2,2,0,6,6,9
6472,"Forbflaith, daughter of Cairell the judex",,F,0,2,2,0,2,2,66
6474,Richard Maitland (fl.1228x60),,M,0,2,2,0,3,3,9
6562,"Reginald (Ragnvald), lord of Argyll",,M,0,2,2,0,3,3,66
6566,"Rory, son of Reginald (Ragnvald)",,M,0,2,2,0,2,2,66
6598,"Robert Bruce VI, earl of Carrick (d.1304)",,M,0,2,2,0,2,2,71
6680,Robert of Kirkconnell (son of Simon),,M,0,2,2,0,2,2,75
6800,"Eugenius (Ewen), son of Duncan, lord of Argyll (d. ca 1268)",,M,0,2,2,0,2,2,6
7224,"Mauricius (Murdoch) of Luss, lord of Luss",,M,0,2,2,0,2,2,66
7554,"Thomas, clerk, son of William of Collielaw",,M,0,2,2,0,2,2,9
7826,"Thomas, son of Cospatric of Workington/Colvend (d.1201)",,M,0,2,2,0,2,2,75
7859,"Michael Fleming, king's clerk",,M,2,2,4,2,2,4,71
7927,Agnes Bruce,,F,0,2,2,0,2,2,69
7959,Robert Bruce III (d.a.1191),,M,0,2,2,0,2,2,75
7962,Walter del Bois (12C),,M,0,2,2,0,4,4,3
8131,"Adam, son of John of Ayton",,M,0,2,2,0,2,2,3
8138,"Sybil, daughter of Maurice of Ayton",,F,0,2,2,0,2,2,3
8144,"Walter, son of Robert Purroc",,M,1,2,3,1,5,6,3
8224,"Euphemia, wife of Robert Bruce II",,F,0,2,2,0,2,2,75
8493,"Dougal, son of Christian of Lennox ",,M,0,2,2,0,3,3,66
8526,"William, son of Henry of Anstruther ",,M,0,2,2,0,2,2,69
8671,Gilbert de Camera,,M,1,2,3,1,2,3,7
8721,William of Horndean,,M,0,2,2,0,2,2,72
8830,"Michael Scott, son of Malothen (1230s)",,M,0,2,2,0,2,2,73
8908,"Vincent Avenel, son of Robert Avenel",,M,0,2,2,0,3,3,71
8942,William of Halkerston,,M,0,2,2,0,3,3,71
8943,"Richard, brother of William of Halkerston",,M,0,2,2,0,3,3,71
8966,"Ralph de Clare, son of Ralph de Clare",,M,1,2,3,1,4,5,72
8969,"Gilbert Avenel, son of Willam Avenel (13C)",,M,0,2,2,0,2,2,72
9134,Alexander of the River,,M,0,2,2,0,2,2,72
9138,"William, son of Robert (BWK)",,M,0,2,2,0,4,4,9
9571,"Morgan Macnab, son of John Abb of Brechin",,M,0,2,2,0,2,2,68
9716,Thomas Gordon (son of Thomas),,M,0,2,2,0,11,11,72
9772,Waltheof of Strachan,,M,0,2,2,0,2,2,1
9809,Ranulf/Ralph of Halton,,M,0,2,2,0,2,2,69
9975,William of Hatley,,M,0,2,2,0,2,2,72
10021,"William de Vieuxpont (III), son of Emma",,M,0,2,2,0,11,11,72
10082,Henry of Mow,,M,0,2,2,0,3,3,72
10266,Richard of Lincoln (Junior),,M,1,2,3,2,5,7,72
10367,"John of Ainslie, knight",,M,0,2,2,0,2,2,8
10380,"Simon, thane of Aberchirder",,M,0,2,2,0,2,2,69
10388,"Euphemia, wife of Walter Murray of Duffus",,F,0,2,2,0,2,2,69
10392,"Augustine, son of Robert Augustine, lord of Inverallan",,M,0,2,2,0,2,2,69
10589,"Christiana, daughter of Adam son of Gilbert of Kilbucho",,F,0,2,2,0,2,2,69
10598,"Ralph Burnard, son of Roger Burnard",,M,0,2,2,0,2,2,66
10635,"John, son of Hugh of Redden",,M,0,2,2,0,3,3,72
10709,"Walter, son of David son of Truite",,M,0,2,2,0,2,2,72
10727,"Jordan Brack ",,M,0,2,2,0,2,2,9
10863,"Simon Lockhart, son of Malcolm Lockhart",,M,0,2,2,0,3,3,72
10939,"Alice, daughter of John son of Ranulf of Cramond",,F,0,2,2,0,2,2,73
11080,Malcolm Dunne,,M,0,2,2,0,2,2,66
11083,"Alice, daughter of William de Moreville ",,F,0,2,2,0,2,2,66
11149,Nicholas de Campania (Champagne),,M,0,2,2,0,2,2,69
11246,Margery de Lascelles,,F,0,2,2,0,3,3,73
11255,Ada Colville,,F,0,2,2,0,3,3,1
11424,"Muriel, daughter of Congal son of Duncan",,F,0,2,2,0,2,2,89
11499,"Ralph de Vermelles ",,M,0,2,2,0,3,3,68
11520,Bernard Fraser (in ELO and BWK) (brother of Ness and John of London),,M,1,2,3,1,3,4,1
11599,Reginald of Carriden,,M,0,2,2,0,3,3,71
11629,"Robert de Campania (Champagne), son of Nicholas",,M,0,2,2,0,3,3,9
11678,"Richard, son of Henry Cissor of Durham",,M,0,2,2,0,2,2,3
11760,"Alan, carpenter, son of William the carpenter of Coldingham ",,M,1,2,3,1,2,3,3
11782,"Ralph of Coldingham, doorward",,M,0,2,2,0,2,2,3
11797,"Ralph, messenger, son of Alan, granger of Coldingham ",,M,1,2,3,1,3,4,3
11885,"Adam Wiseman ",,M,0,2,2,0,2,2,3
11911,"Emma, daughter of Elias Dunning ",,F,0,2,2,0,2,2,3
12040,"John of Dunbar, burgess of Berwick",,M,0,2,2,0,2,2,72
12385,Richard Wallace (12C),,M,0,2,2,0,5,5,71
12446,Thomas of Kirkconnell (son of Andrew),,M,0,2,2,0,4,4,75
12454,"Stephen, son of Stephen of Kinnerley",,M,0,2,2,0,4,4,68
12504,"Malcolm of Kilspindie, son of Ralph of Kilspindie",,M,0,2,2,0,2,2,67
12585,"Robert, son of Simon of Nenthorn",,M,0,2,2,0,2,2,69
12675,Henry of Bessingham,,M,1,2,3,1,2,3,9
12852,"Thomas Noble, son of Ralph",,M,1,2,3,1,2,3,66
12902,Hugh Levedyman of Langhope,,M,0,2,2,0,2,2,3
12904,"Eve, wife of hugh Levedyman",,F,0,2,2,0,2,2,3
12994,William of Lumley,,M,0,2,2,0,2,2,3
13396,"Roger, lardiner",,M,0,2,2,0,2,2,3
13653,David Lindsay (I or II),,M,0,2,2,0,2,2,68
13654,"Christiana or Christina, wife of Walter of Lundin",,F,0,2,2,0,2,2,73
13683,"Patrick, son of Thomas of Quixwood",,M,0,2,2,0,2,2,3
13914,John de Vescy (d.1289),,M,0,2,2,0,3,3,71
14038,Alexander of Hadden,,M,0,2,2,0,2,2,69
14049,"Adam of Glasgow, burgess of Berwick",,M,0,2,2,0,2,2,69
14405,"Angier, son of Moses ",,M,0,2,2,0,2,2,69
14445,Magnus of Monorgan (son of Gilbert),,M,0,2,2,0,3,3,73
14557,Walter of Simprim,,M,0,2,2,0,2,2,3
14558,"Cecilia, wife of Walter of Simprim",,F,0,2,2,0,2,2,3
14598,"William, son of Beatrice of Swinton ",,M,0,2,2,0,2,2,3
14705,"Richard, son of Lesceline",,M,0,2,2,0,3,3,75
14711,"Michael, son of Matthew",,M,0,2,2,0,2,2,75
14834,William de Mayle of Bassendean,,M,0,2,2,0,2,2,72
14866,"Roger Norris, burgess of Berwick",,M,0,2,2,0,2,2,69
15158,John of Saltoun,,M,0,2,2,0,2,2,9
15159,"Agnes, wife of John of Saltoun",,F,0,2,2,0,2,2,9
15262,"William of Fintray, burgess of Aberdeen",,M,0,2,2,0,3,3,69
15338,"Henry, son of Malise steward of Strathearn",,M,0,2,2,0,4,4,89
15554,"William de Somerville (II), son of William ",,M,0,2,2,0,2,2,66
16030,"Gilbert or Gilla Brigte of Glencarnie (III), son of Gilbert (II)",,M,0,2,2,0,2,2,24
16046,Geoffrey Ridel (12/13C ROX),,M,0,2,2,0,3,3,72
16971,"William Murray, lord of Bothwell, pantler of Scotland",,M,0,2,2,0,2,2,70
4,"Ness, son of William, lord of Leuchars (d.1178x83)",,M,0,1,1,0,2,2,73
9,"William Gifford, son of Hugh Gifford, lord of Yester",,M,2,1,3,5,1,6,68
17,"John (I) Hastings, sheriff (12/13C)",,M,0,1,1,0,1,1,68
29,Scone Abbey (fd.c.1120),,I,43,1,44,92,1,93,73
31,"Hugh Gifford, lord of Yester",,M,2,1,3,3,1,4,68
34,"Humphrey Barclay, son of Theobald",,M,1,1,2,2,1,3,68
35,Roger de Mortimer (d.1217x27),,M,1,1,2,3,1,4,68
43,"John, abbot of Lindores (fl.1219-44)",,M,1,1,2,1,1,2,67
49,"William of Gullane, rector of Gullane",,M,2,1,3,3,1,4,68
71,"Swain, son of Thor of Ruthven (father of Alan)",,M,0,1,1,0,1,1,73
76,"Oswulf, son of Uhtred",,M,0,1,1,0,1,1,71
83,David Oliphant (12C),,M,0,1,1,0,1,1,9
84,"Ela, countess of Fife",,F,0,1,1,0,1,1,73
127,Newbattle Abbey (fd.1140),,I,85,1,86,150,1,151,1
128,Dryburgh Abbey (fd.1150),,I,119,1,120,198,1,199,9
145,Hugh Ridel (I),,M,0,1,1,0,1,1,72
152,"Herbert, king's chamberlain",,M,0,1,1,0,1,1,68
156,"Cecilia, wife of Robert Barclay",,F,0,1,1,0,1,1,71
173,"Baldwin of Biggar, sheriff of Lanark",,M,0,1,1,0,1,1,66
184,William de Somerville (I),,M,0,1,1,0,1,1,66
185,Geoffrey (I) Melville,,M,1,1,2,1,2,3,73
187,"Richard, nepos of Simon",,M,4,1,5,5,1,6,3
201,"John of Hownam, son of Orm, son of Eilaf",,M,0,1,1,0,1,1,71
202,"Andrew, bishop of Caithness (d.1184)",,M,1,1,2,1,1,2,73
226,"Merleswain, son of Colban, lord of Kennoway (fl.1150s-90s)",,M,1,1,2,1,1,2,68
232,"Christian, bishop of Whithorn (d.1186)",,M,0,1,1,0,1,1,68
237,"Morgan, earl of Mar (d.1182x83)",,M,0,1,1,0,3,3,73
258,William Uvieth,,M,0,1,1,0,1,1,73
272,Duncan de Lascelles (d.1227x9),,M,0,1,1,0,1,1,73
298,Walter Corbet,,M,0,1,1,0,6,6,72
302,"Henry Lovell, lord of Hawick",,M,0,1,1,0,1,1,73
317,"Edward, bishop of Aberdeen (d.1171)",,M,0,1,1,0,1,1,73
318,"Laurence, bishop of Dunblane",,M,0,1,1,0,1,1,68
328,"Serlo, clerk (fl.1156x66)",,M,0,1,1,0,1,1,72
338,"Alwine, abbot of Holyrood (d.1155)",,M,0,1,1,0,1,1,1
340,Thomas of London,,M,0,1,1,0,1,1,9
346,"Henry de Percy, son of Alan",,M,0,1,1,0,1,1,9
362,"Alexis, papal legate",,M,0,1,1,0,1,1,73
377,Hye of Simprim,,M,0,1,1,0,1,1,72
380,"Uhtred of Mow, son of Liulf",,M,0,1,1,0,1,1,72
381,Wice of Wiston,,M,0,1,1,0,1,1,72
389,"Edward, son of Earl Cospatric",,M,0,1,1,0,1,1,73
403,Ralph Ridel,,M,0,1,1,0,1,1,73
408,"Alexander, abbot of Coupar Angus (fl.1209-40)",,M,0,1,1,0,1,1,1
416,"Duncan, earl of Angus (d.x1214)",,M,0,1,1,0,2,2,68
417,"Gilchrist, earl of Angus (d.x1206)",,M,0,1,1,0,6,6,68
421,"Laurence, bishop of Argyll (d.1299x1300)",,M,0,1,1,0,1,1,66
461,"Geoffrey, abbot of Kelso (fl.1203)",,M,0,1,1,0,1,1,77
463,"German, prior of Coldingham (fl.1260)",,M,0,1,1,0,1,1,72
469,"Gilbert, bishop of Whithorn (d.1253)",,M,0,1,1,0,2,2,9
471,"Gilbert, prior of St Andrews",,M,0,1,1,0,1,1,68
472,"Gilbert, prior of St Andrews (d.1264)",,M,0,1,1,0,1,1,67
492,"Laurence, abbot of Melrose (d.1178)",,M,0,1,1,0,1,1,76
524,"Thor, son of Swain, lord of Tranent, sheriff of Edinburgh",,M,0,1,1,0,1,1,68
529,"Alan de Percy (le Meschin), son of Alan",,M,0,1,1,0,1,1,9
532,"Robert de Burneville, sheriff",,M,0,1,1,0,1,1,72
562,"William, son of Thor, sheriff of Stirling",,M,0,1,1,0,1,1,68
568,"Ragnvald, earl of Orkney (d.1158)",,M,0,1,1,0,1,1,75
657,Bernard Balliol (d.1154x62),,M,0,1,1,0,1,1,72
666,"Ralph, son of Dungal (d.c.1185)",,M,0,1,1,0,1,1,75
750,"Robert Barclay, brother of Walter",,M,0,1,1,0,1,1,71
764,"Elias, son of Nicholas, abbot of Holyrood",,M,0,1,1,0,1,1,66
767,"German, prior of Durham (d.1189)",,M,0,1,1,0,1,1,97
768,"William of Greenlaw, master (d.1247)",,M,2,1,3,3,1,4,72
775,"Hugh, bishop of Brechin (d.1218)",,M,0,1,1,0,6,6,68
779,"John, king of England (d.1216)",,M,1,1,2,2,1,3,68
793,"Turpin, bishop of Brechin  (fl.1165x69-1189x98)",,M,0,1,1,0,5,5,68
802,"Matthew, dean of Dunkeld (1214-36)",,M,0,1,1,0,1,1,79
812,"Richard I, king of England (d.1199)",,M,0,1,1,0,1,1,68
813,"Richard, abbot of Coupar Angus (fl.1207-09)",,M,0,1,1,0,1,1,81
830,"Walter, bishop of Whithorn (d.1235)",,M,0,1,1,0,1,1,9
839,Richard de Munfichet (Muschet),,M,1,1,2,1,1,2,68
844,William Ogilvie,,M,0,1,1,0,1,1,74
851,Richard de FrÄŹĹĽËťville (Friville),,M,0,1,1,0,2,2,68
854,"Gervase Avenel, lord of Eskdale (d.1219)",,M,0,1,1,0,3,3,71
855,"Bernard, son of Brian, lord of Hadden",,M,0,1,1,0,2,2,72
869,"Simon, prior of Coldingham (fl.1189x1203)",,M,0,1,1,0,1,1,82
884,"Thomas, abbot of Dryburgh  (fl.1200x34)",,M,0,1,1,0,1,1,9
887,"Richard, son of Hugh de Camera",,M,0,1,1,0,1,1,73
892,"William of Conisbrough, lord of Staplegordon",,M,0,1,1,0,1,1,72
896,"Henry Graham, son of Peter, sheriff",,M,0,1,1,0,1,1,1
900,"Adam, son of Gilbert, son of Richer, lord of Kilbucho",,M,3,1,4,3,1,4,73
905,"David Lindsay (I), son of William (II) (d.c.1220)",,M,0,1,1,0,1,1,1
915,"Robert, son of Warnebald, sheriff of Lanark (d.1242x45)",,M,1,1,2,1,3,4,68
917,Henry of Carmunnock,,M,0,1,1,0,1,1,66
933,"William of Hownam, son of John, son of Orm (d.1227)",,M,1,1,2,1,2,3,71
936,Robert Hunaud,,M,1,1,2,1,2,3,72
937,"Roland, son-in-law of Nicholas de CÄŹĹĽËťtentin",,M,1,1,2,1,2,3,72
939,Nicholas de CÄŹĹĽËťtentin,,M,0,1,1,0,1,1,66
941,Reginald Prat of Tynedale (TRW),,M,0,1,1,0,1,1,68
942,Hugh of Calder,,M,0,1,1,0,1,1,73
947,"Patrick, son of Cospatric, earl of Dunbar",,M,0,1,1,0,1,1,72
960,"Aed/Hugh, son of Aed, son of Gilla Micheil earl of Fife (fl.1160s)",,M,0,1,1,0,1,1,73
961,"Henry of Braid, sheriff of Edinburgh (early 13C)",,M,0,1,1,0,1,1,68
966,Henry Revel,,M,1,1,2,1,1,2,68
1019,Walter of Windsor,,M,0,1,1,0,1,1,71
1020,"Adam, son of Odo of Kinninmonth",,M,3,1,4,5,1,6,68
1023,"Gilchrist, abbot of cÄŹĹĽËťli De of St Andrews",,M,0,1,1,0,1,1,73
1037,"Hugh Freskin, lord of Sutherland (d.p.1214)",,M,0,1,1,0,1,1,78
1039,Lindores Abbey (fd1190),,I,69,1,70,111,1,112,67
1040,"Hugh de Normanville, lord of Maxton",,M,0,1,1,0,1,1,71
1052,Walcher de Chartres,,M,0,1,1,0,1,1,72
1056,"Muriel, wife of Robert of Landells",,F,0,1,1,0,1,1,72
1059,"Matilda, daughter of Anselm of Mow",,F,1,1,2,1,3,4,72
1072,Simon Lockhart (12C),,M,0,1,1,0,1,1,72
1077,William de Mortimer (12C),,M,0,1,1,0,1,1,73
1079,"Alexander of Synton (II), sheriff of Fife (d.1293)",,M,0,1,1,0,1,1,72
1084,Thomas Thancard,,M,0,1,1,0,1,1,68
1099,"William, earl of Sutherland (d.1248)",,M,0,1,1,0,1,1,78
1102,"William, son of William, son of Freskin (William II Freskin aka Murray (d.1226))",,M,0,1,1,0,1,1,68
1104,"Eadwulf, son of Gamel",,M,0,1,1,0,2,2,72
1118,Ivo de Vieuxpont,,M,1,1,2,1,1,2,9
1138,"Henry Bald, burgess of Perth",,M,1,1,2,1,1,2,73
1157,"Uhtred, son of Oswulf",,M,0,1,1,0,1,1,71
1170,"Walter, son of Sibbald",,M,0,1,1,0,1,1,68
1173,Robert Crook,,M,1,1,2,1,1,2,66
1194,Holm Cultram Abbey (fd.1150),,I,35,1,36,49,1,50,75
1206,"John of Gullane, clerk of bishop William Malveisin",,M,0,1,1,0,1,1,3
1219,"Walter, son of Walter Corbet",,M,0,1,1,0,1,1,71
1226,"Geoffrey, son of Richard, of Inverkunglas, sheriff",,M,1,1,2,3,1,4,68
1228,"John of Stirling, knight, sheriff of Stirling",,M,0,1,1,0,1,1,70
1232,"Eve, wife of Philip Melville",,F,0,1,1,0,1,1,68
1233,"Philip Melville, justiciar of Scotia",,M,0,1,1,0,1,1,68
1238,Robert of Roos (II) (d.1226/7),,M,0,1,1,0,1,1,68
1257,Donald Abb of Brechin,,M,0,1,1,0,1,1,68
1267,Robert de Quarrantilly,,M,0,1,1,0,1,1,9
1296,William Noble of Garleton,,M,1,1,2,1,1,2,1
1298,"John Abb, son of Malise of Brechin",,M,0,1,1,0,1,1,68
1316,"Gilbert or Gilla Brigte Scott of Monorgan, son of Ewen, nepos of Bishop Andrew",,M,2,1,3,2,1,3,67
1320,"David Hastings, earl of Atholl (d.1247)",,M,0,1,1,0,2,2,74
1329,Roger de St Michael,,M,0,1,1,0,1,1,68
1339,Ralph de Vere,,M,0,1,1,0,1,1,72
1344,"Hugh Malherbe (II), son of Hugh",,M,0,1,1,0,1,1,68
1367,"William, son of Bernard",,M,0,1,1,0,3,3,68
1373,"Richard, son of Michael of Peaston, expensarius",,M,0,1,1,0,2,2,70
1380,"Dougal, son of Suibne (MacSween)",,M,0,1,1,0,1,1,66
1384,"Bernard, son of William, son of Bernard",,M,0,1,1,0,3,3,68
1390,"John Murray, son of John of London",,M,0,1,1,0,2,2,1
1391,Fulk Soulis,,M,0,1,1,0,1,1,1
1399,"Margaret, daughter of Orm of Abernethy, wife of Henry Revel",,F,0,1,1,0,1,1,73
1456,"Olaf I, king of the Isles (d.ca.1153)",,M,0,1,1,0,1,1,9
1536,"Unknown, king of the Isles",,M,0,1,1,0,1,1,83
1674,Roger d'Eu (12C),,M,0,1,1,0,1,1,72
1738,"Elias, canon of Glasgow (2)",,M,0,1,1,0,1,1,66
1774,Thomas (I) of Morham,,M,0,1,1,0,1,1,1
1790,"Norman, son of Malcolm, constable of Inverurie (d.c.1243)",,M,1,1,2,2,1,3,67
1802,"William Wascelin, knight",,M,0,1,1,0,1,1,67
1847,"Peter of Paxton, master",,M,0,1,1,0,2,2,68
1848,"Ada, daughter of Earl David, wife of Malise of Strathearn",,F,0,1,1,0,1,1,67
1886,"Richard of Potton, bishop of Aberdeen (d.1270 or 1272)",,M,0,1,1,0,1,1,86
1900,Richard Ridel,,M,0,1,1,0,2,2,72
1933,"John, prior of May (fl.c.1204-15)",,M,0,1,1,0,1,1,84
1958,"Andrew Fraser, knight",,M,0,1,1,0,1,1,72
1968,"Elphin (Alpin?), prior of Inchaffray  (fl.1219-20)",,M,0,1,1,0,1,1,67
1976,"Roger of Derby, precentor of Aberdeen (d.a.1270)",,M,0,1,1,0,1,1,73
1977,"Laurence of Daleri, minister of Aberdeen Friars (fl.1273-93)",,M,0,1,1,0,2,2,85
1979,"William de Crachin, dean of Brechin (d.1269x75)",,M,0,1,1,0,1,1,68
1986,"Gerard Lindsay, son of David (I) (d.1249)",,M,0,1,1,0,3,3,1
1989,"Hugh of Benholm, bishop of Aberdeen (d.1282)",,M,0,1,1,0,1,1,86
2005,"David Graham, lord of Lovat (d.c.1272)",,M,10,1,11,15,1,16,66
2008,"Simon (de Gunby), bishop of Moray (d.1251)",,M,1,1,2,1,2,3,10
2013,Simon of Gartly,,M,1,1,2,1,1,2,67
2021,"Gregory, prior of Whithorn (fl.1235x1254)",,M,0,1,1,0,2,2,9
2035,"Walter of Kirkham, bishop of Durham (d.1260)",,M,0,1,1,0,1,1,88
2048,"Gervase Ridel, later canon of Jedburgh",,M,0,1,1,0,1,1,73
2051,Gilbert de Umfraville (d.1245),,M,0,1,1,0,4,4,72
2064,Roger Wyrfaut,,M,2,1,3,2,2,4,73
2065,Robert Menzies (d.1267),,M,0,1,1,0,1,1,74
2068,Walter Bisset (13C),,M,0,1,1,0,1,1,74
2071,"William Hay (IV), lord of Borthwick (son of John)",,M,0,1,1,0,2,2,1
2090,Richard Burnard of Fairnington,,M,0,1,1,0,1,1,71
2092,"Nicholas Corbet, lord of Fogo (d.1280)",,M,0,1,1,0,3,3,71
2093,"Henry of Lambden, abbot of Kelso (d.1275?)",,M,1,1,2,1,1,2,9
2099,William Comyn of Kilbride (d.c.1283),,M,0,1,1,0,1,1,91
2111,Richard Wallace (13C),,M,0,1,1,0,1,1,71
2134,"Robert Wishart, bishop of Glasgow (d.1316)",,M,5,1,6,6,1,7,66
2138,"William Soulis, knight, justiciar of Lothian (d.1292/3)",,M,0,1,1,0,1,1,73
2139,Thomas Randolph (d.c.1296),,M,1,1,2,1,1,2,71
2146,William Galbraith,,M,0,1,1,0,1,1,66
2147,"Henry of Ashkirk, son of William",,M,0,1,1,0,1,1,72
2150,"Adam of Polwarth, son",,M,0,1,1,0,1,1,66
2155,"Forbflaith, wife of Norrin of Monorgan",,F,0,1,1,0,1,1,66
2161,Norrin of Monorgan,,M,0,1,1,0,1,1,66
2187,"Colban, earl of Fife (d.1270x72)",,M,0,1,1,0,1,1,67
2190,"Robert Mowat, knight, justiciar, sheriff of Forfar",,M,0,1,1,0,1,1,74
2203,Henry of Halliburton (mid 13C),,M,0,1,1,0,1,1,72
2207,"Robert Bisset, knight, lord of Upsettlington",,M,0,1,1,0,1,1,72
2212,Fergus Comyn,,M,0,1,1,0,1,1,68
2216,"William Abernethy I, knight",,M,0,1,1,0,1,1,9
2228,Alexander of Lamberton (son of William),,M,1,1,2,1,1,2,71
2234,"Nicholas Hay (I), lord of Errol (son of Gilbert) (d.1305/6)",,M,11,1,12,11,1,12,67
2235,Nicholas de Vieuxpont,,M,0,1,1,0,1,1,70
2238,"John of Kinross (I), knight",,M,0,1,1,0,1,1,94
2255,"Thomas Becket, archbishop of Canterbury (d.1170)",,M,0,1,1,0,1,1,68
2265,"Emma, daughter of Gilbert of Smeaton",,F,0,1,1,0,1,1,73
2266,Gilbert of Smeaton,,M,0,1,1,0,1,1,73
2277,John of Strachan,,M,0,1,1,0,1,1,67
2303,Thomas of Lessudden,,M,0,1,1,0,1,1,9
2310,"Duncan (III), earl of Fife (d.1289)",,M,0,1,1,0,1,1,67
2315,"Stephen Langton, archbishop of Canterbury",,M,0,1,1,0,1,1,68
2318,"John, abbot of Dunfermline (d.1256)",,M,0,1,1,0,1,1,73
2328,"Thomas de Normanville, knight",,M,1,1,2,1,1,2,71
2330,"Hugh de Gourlay, knight (son of Hugh), steward of Earl Patrick",,M,0,1,1,0,1,1,1
2333,"John Wishart (II), knight (d.a.1286)",,M,2,1,3,2,1,3,68
2347,Helen de la Zouche (d.1296),,F,0,1,1,0,1,1,9
2359,Patrick Edgar (son of Walter),,M,0,1,1,0,1,1,72
2417,"Hugh of Avallon, bishop of Lincoln (d.1200)",,M,0,1,1,0,1,1,68
2478,"Agnes, countess of Mar",,F,0,1,1,0,2,2,73
2493,"Robert Hay, clerk (son of William)",,M,0,1,1,0,1,1,67
2545,"Malcolm, son of Earl Morgan of Mar",,M,0,1,1,0,1,1,73
2577,Henry of Prenderguest (II) knight,,M,6,1,7,7,1,8,3
2579,"Elizabeth, wife of William of Scremerston",,F,0,1,1,0,1,1,3
2615,"Mael Brigte MacLeod, prior of celi De of Brechin",,M,0,1,1,0,1,1,68
2661,Chapter of Lincoln,,I,0,1,1,0,1,1,98
2668,Robert de Vaux,,M,0,1,1,0,1,1,9
2717,"Robert, clerk, nepos of Philip, clerk of Dundee",,M,0,1,1,0,1,1,68
2838,"Henry, husband of Ada, neptis of Richard, bishop of Dunkeld",,M,0,1,1,0,1,1,74
2915,"Thurstan, son of Leving",,M,0,1,1,0,1,1,68
2939,"John, dean of Kinghorn (fl.1195x98-1200x02)",,M,0,1,1,0,1,1,74
2951,"Geoffrey, abbot of Dunfermline (I or II)",,M,1,1,2,1,1,2,73
2986,Walter HosÄŹĹĽËť,,M,0,1,1,0,1,1,66
2999,Roger of Skelbrooke,,M,0,1,1,0,2,2,71
3026,"Hugh of Nydie (I), butler of bishop of St Andrews",,M,1,1,2,1,1,2,99
3091,"William, son of William de Montfort",,M,0,1,1,0,1,1,67
3203,"Duncan, son of Fearchar",,M,0,1,1,0,1,1,66
3204,"Lagmann, son of Malcolm MacFearchar",,M,0,1,1,0,2,2,66
3218,"Odo, dean of Glassary (fl.1284)",,M,0,1,1,0,1,1,66
3221,"Maurice or Murdoch, chaplain of St Finan",,M,0,1,1,0,1,1,66
3236,"Malcolm, precentor of Dunkeld (fl.1238-58x61)",,M,0,1,1,0,1,1,9
3239,"Thomas of Perth (Bell), master (fl.1259-75)",,M,0,1,1,0,1,1,73
3253,"Robert of Lanark, subdean of Glasgow (d.1274x79x)",,M,0,1,1,0,1,1,66
3264,"Walter of Roxburgh, nephew of Archdeacon Walter",,M,0,1,1,0,1,1,100
3292,"Mary, wife of Reginald Cheyne younger",,F,1,1,2,1,1,2,69
3293,"Freskin Murray, knight, lord of Duffus",,M,1,1,2,2,1,3,10
3297,"William of Fenton, lord of Beaufort",,M,0,1,1,0,1,1,67
3313,"Hugh Blund, lord of Arbuthnott",,M,0,1,1,0,1,1,68
3314,"Merleswain, son of Merleswain of Kennoway (fl.1170s)",,M,0,1,1,0,1,1,73
3317,"William, abbot of Dunfermline (I or II?)",,M,1,1,2,1,1,2,69
3394,"Ralph of Dundee, son of Gregory Long, master, clerk (d.1306x07)",,M,3,1,4,3,1,4,67
3403,"William Lindsay, dean of Glasgow (d.p.1246/7)",,M,1,1,2,1,1,2,66
3428,"Angus, son of Donald of the Isles, lord of Islay (d. ca 1293)",,M,0,1,1,0,2,2,66
3429,"Donald, son of Rognvald of the Isles (father of Angus)",,M,0,1,1,0,1,1,66
3446,"Macbeth, rex scolarum of Dunblane",,M,0,1,1,0,1,1,67
3455,"Andrew, rector of Inchture",,M,0,1,1,0,1,1,73
3459,"Mael Domnaig, rex scolarum of Muthill",,M,0,1,1,0,1,1,67
3461,Clerks of Methven,,M,0,1,1,0,1,1,67
3481,"Robert IV, abbot of Scone (fl.1240-70)",,M,1,1,2,1,1,2,67
3504,Chapter of Brechin,,I,0,1,1,0,1,1,68
3522,"David Hay, rector of Errol (son of David)",,M,0,1,1,0,1,1,67
3528,"Ralph of Synmerdisburn, rector of Arngask",,M,0,1,1,0,1,1,68
3530,"Roger, rector of Elsdon (Northumberland)",,M,0,1,1,0,1,1,72
3564,"Nigellus (Niall), abbot of Kilwinning  (fl.1201-10)",,M,0,1,1,0,1,1,71
3585,"A., rector of Clockston (fl.1226)",,M,1,1,2,1,1,2,71
3591,"William Gley, burgess of Glasgow",,M,0,1,1,0,1,1,9
3656,"William, vicar of Oldcambus",,M,0,1,1,0,1,1,3
3659,David of Lumsdaine,,M,1,1,2,1,1,2,3
3672,"Elias, smith of Coldingham",,M,0,1,1,0,1,1,3
3673,William of Mordington,,M,0,1,1,0,1,1,3
3676,"William, son of Waltheof of Reston",,M,0,1,1,0,1,1,3
3679,"Robert of Bernham, rector of Tyninghame",,M,0,1,1,0,1,1,72
3699,"Adam, son of Philip",,M,0,1,1,0,1,1,11
3702,"Richard Murray, precentor of Moray (fl.1226-30)",,M,1,1,2,1,1,2,69
3705,"Ranulf, archdeacon of Moray",,M,0,1,1,0,1,1,69
3713,"Patrick (II or III), earl of Dunbar",,M,0,1,1,0,1,1,71
3715,"Walter, chaplain (son of Walter, son of Siward)",,M,1,1,2,1,2,3,72
3717,"Nicholas of Heysham, dean of Lincoln",,M,0,1,1,0,1,1,98
3735,"John, persona of Pencaitland",,M,0,1,1,0,1,1,66
3769,Patrick McWhirter,,M,0,1,1,0,2,2,66
3789,Alexander de NÄŹĹĽËťhou,,M,0,1,1,0,1,1,9
3791,"Malcolm, prior of Whithorn (fl.1209x26)",,M,0,1,1,0,1,1,9
3793,Ralph de Campania (Champagne),,M,0,1,1,0,1,1,9
3893,William of Rosedale,,M,0,1,1,0,1,1,75
3899,Kilwinning Abbey,,I,5,1,6,5,1,6,92
3912,William Oliphant (d.c.1247),,M,0,1,1,0,1,1,74
3993,Richard of Liddell,,M,0,1,1,0,1,1,12
4022,"Richard Germine, lord of Lempitlaw",,M,0,1,1,0,2,2,70
4036,"Laurence, son of Guy, judex of Perth",,M,0,1,1,0,1,1,71
4151,William de Mortimer (mid 13C),,M,2,1,3,2,1,3,1
4166,"Mariota, daughter of Samuel",,F,1,1,2,1,1,2,71
4185,"Alan of Hartside, serviens",,M,0,1,1,0,1,1,13
4191,"Humbald, prior of Wenlock",,M,0,1,1,0,1,1,66
4196,"Stephen, abbot of Cluny (1163-73)",,M,0,1,1,0,1,1,66
4218,"Malcolm, son of Ewen of Dunkeld",,M,0,1,1,0,1,1,74
4219,"William of Mitford, master, vicar of Dundee",,M,1,1,2,2,1,3,67
4241,Simon of Ogston,,M,0,1,1,0,1,1,14
4245,"Laurence Mowat, clerk, persona of Kinnettles (fl.1250s-ca.1272)",,M,1,1,2,1,1,2,67
4390,"Richard, abbot of Kelso (d.1221)",,M,1,1,2,1,1,2,66
4395,"Robert de Keldeleth, abbot of Melrose (d.1273)",,M,0,1,1,0,1,1,15
4406,Bernard of Ripley,,M,0,1,1,0,1,1,75
4410,"Isabel, daughter of Earl David, wife of Robert IV Bruce (d.1251)",,F,0,1,1,0,1,1,67
4411,"Nicholas Soulis, lord of Liddesdale (d.1265)",,M,0,1,1,0,1,1,1
4414,Adam Hastings,,M,0,1,1,0,1,1,68
4424,"Ela de St Martin, daughter of Alexander de St Martin",,F,0,1,1,0,1,1,1
4431,Hospital of Brackley,,I,5,1,6,5,1,6,68
4454,"Walter, son of Alan of Ruthven, knight",,M,1,1,2,1,1,2,73
4461,"Forbflaith, countess of Atholl",,F,0,1,1,0,1,1,74
4509,"Waltheof, son of Merleswain (fl.1198x1226)",,M,0,1,1,0,1,1,73
4512,"William, abbot of Holyrood (IV) (fl.1221-27)",,M,0,1,1,0,1,1,71
4539,Thomas de Aunay,,M,1,1,2,1,1,2,71
4549,"Alexander of Stirling, son of Patrick",,M,0,1,1,0,1,1,68
4555,Duncan of Swanston,,M,0,1,1,0,3,3,70
4556,"Mariota, wife of Duncan of Swanston",,F,0,1,1,0,4,4,70
4570,"Aulay, brother of Earl Mael Domnaig of Lennox",,M,1,1,2,1,3,4,66
4587,Stephen of Blair (PER),,M,0,1,1,0,1,1,74
4605,W. Lindsay (Walter or William?),,M,0,1,1,0,1,1,71
4608,"William, abbot of Dunfermline (II) (d.1238)",,M,1,1,2,1,1,2,73
4609,"William Blund, sheriff of Perth and Scone",,M,0,1,1,0,1,1,73
4624,William of Bunkle,,M,0,1,1,0,1,1,66
4641,"Duncan, son of Michael Scott (1230s)",,M,0,1,1,0,1,1,73
4654,Clergy of Brechin,,M,0,1,1,0,1,1,68
4656,"Thomas Malherbe (II), sheriff of Forfar",,M,0,1,1,0,1,1,68
4660,"Roger, son of Glay",,M,0,1,1,0,1,1,71
4667,Colin Durward,,M,0,1,1,0,1,1,68
4682,David Lindsay (III) of Barnweill (d.c.1268),,M,1,1,2,1,1,2,71
4704,Alan de Lascelles (d.p.1204),,M,0,1,1,0,1,1,73
4710,"Bartholomew Fleming, knight",,M,0,1,1,0,2,2,16
4728,Gilbert or Gilla Brigte Durward,,M,2,1,3,2,1,3,69
4740,Richard Baird,,M,0,1,1,0,1,1,66
4743,"Fearchar, earl of Ross (d.1251)",,M,0,1,1,0,1,1,17
4751,Eustace de Stuteville (d.1241),,M,0,1,1,0,1,1,70
4764,Christiana or Christina Corbet (d.1241),,F,1,1,2,1,2,3,73
4792,"Robert, abbot of Arbroath (fl.1261-67)",,M,0,1,1,0,1,1,73
4797,"Walter Melville, burgess of Aberdeen",,M,2,1,3,2,2,4,92
4819,"Robert, son of Warnebald (12C)",,M,2,1,3,2,1,3,69
4838,Richard de Umfraville (d.1226),,M,0,1,1,0,1,1,72
4862,"William, son of Hawock of Perth",,M,0,1,1,0,2,2,67
4869,"Gilla Muire, son of Gilla Conaill",,M,1,1,2,1,1,2,66
4871,"Philip, abbot of Scone (fl.1230-42)",,M,0,1,1,0,1,1,73
4911,"Adam Gordon II, knight, son of Adam",,M,0,1,1,0,1,1,9
4931,Adam Long of Hume,,M,1,1,2,1,2,3,73
4954,"Roger de Wolviston, prior of Coldingham (fl.1263-74x76)",,M,4,1,5,4,1,5,3
4966,"Peter, son of Peter de Rupe",,M,0,1,1,0,1,1,73
5041,"Walter, master of nuns of Haddington",,M,0,1,1,0,1,1,73
5042,"Unknown, prioress of Haddington",,F,0,1,1,0,1,1,73
5045,Duncan Ramsay,,M,1,1,2,1,1,2,73
5058,Simon Post of Berwick,,M,0,1,1,0,1,1,1
5061,"Thomas, son of Eustace (mid13C)",,M,0,1,1,0,1,1,73
5085,"Robert de Turville, master of Knights Templars in England",,M,0,1,1,0,1,1,67
5086,"Simon of Lynn, burgess of Perth",,M,0,1,1,0,1,1,67
5098,Stephen of Kinnerley,,M,0,1,1,0,1,1,68
5113,"Robert de Samford, minister of Knights Templar in England",,M,0,1,1,0,1,1,18
5132,"William de Samilee, master of Hospital of Jerusalem of Torphichen",,M,0,1,1,0,1,1,19
5140,"Savaric, prior of La CharitÄŹĹĽËť-sur-Loire",,M,0,1,1,0,1,1,66
5164,"William, abbot of Balmerino (Pearsby?)",,M,0,1,1,0,1,1,20
5169,"Ralph, abbot of Holyrood (fl.1253x58)",,M,0,1,1,0,1,1,1
5208,"Archibald, master of the House of Torphichen",,M,0,1,1,0,1,1,1
5211,Robert of Roxburgh,,M,0,1,1,0,1,1,9
5230,"Hubert of Chellecham, master of Hospital of Jerusalem of Torphichen",,M,0,1,1,0,1,1,67
5272,"Mary, prioress of Coldstream",,F,0,1,1,0,1,1,21
5277,"Henry of Stirling, burgess of Berwick",,M,0,1,1,0,1,1,68
5282,"Alan, prior of Hospitallers of Jerusalem in England",,M,0,1,1,0,1,1,68
5297,David Ruffus of Forfar,,M,1,1,2,1,1,2,74
5304,Michael of Meigle (I),,M,0,1,1,0,1,1,74
5324,William of Lumsdaine,,M,0,1,1,0,1,1,3
5328,John of Hunsingore,,M,3,1,4,4,1,5,3
5331,Patrick Dreng of Renton,,M,0,1,1,0,2,2,3
5342,Thomas of Nisbet,,M,0,1,1,0,2,2,71
5374,"Peter of Mordington, knight",,M,0,1,1,0,1,1,22
5388,"Adam, son of Eilaf of Auchencrow",,M,0,1,1,0,1,1,3
5394,"Thomas, prior of Durham (d.1162/3)",,M,0,1,1,0,1,1,97
5423,Henry of Prenderguest (I),,M,0,1,1,0,2,2,3
5428,"Hugh of Darlington, prior of Durham (d.1290)",,M,0,1,1,0,2,2,3
5473,"William Comyn, clerk, son of Earl William",,M,0,1,1,0,1,1,73
5520,Heirs of Buchan (of William and Marjory),,M/F,0,1,1,0,1,1,73
5543,"Adam, son of Angus",,M,0,1,1,0,1,1,74
5613,"John, abbot of Kilwinning (fl.1221x30)",,M,1,1,2,1,1,2,66
5665,"Ewen, son of Conan son of Henry",,M,0,1,1,0,2,2,74
5688,Stephen of Melginch,,M,0,1,1,0,1,1,73
5748,"Mary, wife of Ewen son of Conan",,F,0,1,1,0,1,1,89
5751,"Ada de Courtenay, daughter of Earl Patrick (I) of Dunbar",,F,0,1,1,0,1,1,72
5766,Robert of Shotton,,M,0,1,1,0,3,3,72
5872,"David Graham, son of David Graham (TRW)",,M,2,1,3,2,1,3,72
5885,Gilbert Fraser (12C),,M,1,1,2,1,1,2,77
5928,"Amabel, wife of Norman of Lennel",,F,0,1,1,0,1,1,72
5938,"John, son of Waltheof ",,M,0,1,1,0,1,1,71
5960,Walter of Darnchester (I) (son of Thomas),,M,0,1,1,0,1,1,72
5970,"Walter (II) of Darnchester, chaplain, son of Walter",,M,0,1,1,0,1,1,72
5975,Peter of Graden,,M,0,1,1,0,1,1,23
5979,William of Hume (Junior),,M,0,1,1,0,3,3,72
5989,"Christiana or Christina Bruce, countess of Dunbar",,F,0,1,1,0,1,1,72
6005,"Philip of Pitcox, steward of Earl Patrick (II)",,M,0,1,1,0,3,3,71
6021,"Oliver, son of Kilvert",,M,0,1,1,0,1,1,1
6022,"Adam Fraser, son of Odard Fraser",,M,0,1,1,0,3,3,1
6024,"Mary of Hailes, daughter of Kilvert",,F,0,1,1,0,2,2,1
6058,Michael of Makerstoun,,M,0,1,1,0,1,1,72
6071,Robert de Muschamp (d.1250),,M,0,1,1,0,2,2,72
6132,"Fergus, son of Conaing",,M,0,1,1,0,1,1,66
6177,Elias of Ayton (father of John),,M,0,1,1,0,1,1,3
6178,Stephen of Ayton,,M,0,1,1,0,1,1,3
6187,Robert of Polwarth,,M,0,1,1,0,1,1,72
6192,"Laurence Fraser, knight (son of Adam)",,M,0,1,1,0,2,2,1
6253,Richard of Nydie,,M,0,1,1,0,2,2,71
6333,"Gunnhild, daughter of Waltheof, wife of Uhtred, lord of Galloway",,F,0,1,1,0,1,1,68
6344,Walter of Welham (II),,M,0,1,1,0,1,1,71
6379,"Duncan of Frendraught, knight",,M,1,1,2,1,1,2,24
6413,"Gilbert, son of Cospatric of Southwick",,M,0,1,1,0,1,1,75
6499,Alan of Thirlestane (son of Aelsi),,M,2,1,3,3,1,4,71
6500,Peter Haig (early 13C),,M,0,1,1,0,1,1,9
6515,Vivian de Molineux,,M,0,1,1,0,2,2,70
6516,Patrick of Colvend (d.c.1258),,M,0,1,1,0,1,1,75
6523,Serlo of St Andrews,,M,0,1,1,0,1,1,25
6571,"Fonia, wife of Rognvald lord of Isles",,F,0,1,1,0,1,1,66
6596,Alexander MacDonald of the Isles (son of Angus son of Donald),,M,0,1,1,0,1,1,66
6608,Roger of St Andrews,,M,0,1,1,0,1,1,68
6624,Saer of St Andrews,,M,0,1,1,0,1,1,68
6639,"Sibbald, son of Walter",,M,0,1,1,0,1,1,74
6658,Alan of Falside,,M,0,1,1,0,2,2,73
6664,"Orable, daughter of Ness son of William",,F,0,1,1,0,3,3,73
6691,"Durand, son of Christian of Mabie (father of Michael)",,M,2,1,3,2,1,3,75
6709,Richard de Lascelles (son of Hervey),,M,0,1,1,0,1,1,73
6728,"Gilbert Marshal, earl of Pembroke",,M,0,1,1,0,1,1,71
6738,William de Salle,,M,0,1,1,0,1,1,72
6780,"Robert de Vere, earl of Oxford (d.1221)",,M,0,1,1,0,1,1,71
6879,William Malherbe (II),,M,0,1,1,0,1,1,9
6882,Gilla Micheil mac Eadwulf,,M,0,1,1,0,1,1,66
6889,"Malise, son of Earl Gilbert of Strathearn (d.c.1272)",,M,0,1,1,0,1,1,67
6901,Tristram son of Avice,,M,0,1,1,0,1,1,67
6939,"Ysenda of Kinbuck, wife of Earl Gilbert of Strathearn",,F,0,1,1,0,1,1,67
6953,Robert of Meckphen,,M,0,1,1,0,1,1,67
7039,Walter de Ros,,M,0,1,1,0,1,1,66
7040,"Mary, wife of Walter de Ros",,F,0,1,1,0,1,1,66
7152,"Thomas of Rattray, knight",,M,0,1,1,0,1,1,73
7196,Henry de St Martin,,M,1,1,2,1,2,3,66
7292,"Robert, prior of St Bees",,M,0,1,1,0,1,1,26
7331,"Malcolm, heir of Fergus",,M,0,1,1,0,1,1,66
7344,Thomas of Craminnan,,M,0,1,1,0,2,2,2
7364,"William of Hertford, clerk of Glasgow",,M,0,1,1,0,1,1,66
7514,"John Russell, husband of Isabel, countess of Menteith",,M,0,1,1,0,1,1,74
7515,"Isabel, countess of Menteith",,F,0,1,1,0,1,1,74
7541,"Michael, son of Durand",,M,1,1,2,1,2,3,75
7555,"Anthony Lombard, physician, master, knight",,M,0,1,1,0,2,2,66
7556,John of Auldhouse,,M,0,1,1,0,1,1,66
7627,"Alan de Lascelles, son of Walter (13C)",,M,0,1,1,0,1,1,73
7784,Norman of Leslie (son of Norman son of Malcolm),,M,1,1,2,1,2,3,67
7801,"John of Lambden, son of Walter of Stirling",,M,0,1,1,0,3,3,72
7869,"Liulf, son of Aelsi",,M,0,1,1,0,1,1,27
7871,"Cospatric, heir of Liulf son of Aelsi",,M,0,1,1,0,1,1,27
7872,"Gamel, heir of Liulf son of Aelsi",,M,0,1,1,0,1,1,27
7873,"Macbeth, heir of Liulf son of Aelsi",,M,0,1,1,0,1,1,27
7874,"Reginald, heir of Liulf son of Aelsi",,M,0,1,1,0,1,1,27
7875,"Ecgheard, heir of Liulf son of Aelsi",,M,0,1,1,0,1,1,27
7891,Adam of Lamberton (12C),,M,0,1,1,0,1,1,28
7897,"Waltheof, son of Uhtred of Reston",,M,0,1,1,0,1,1,3
7905,"Adam, son of Leysing",,M,0,1,1,0,1,1,3
7907,William de Umfraville (d.1195),,M,0,1,1,0,1,1,72
7924,Clarebald of Ashby,,M,0,1,1,0,1,1,3
7933,"Maurice of Ayton ",,M,0,1,1,0,1,1,3
7947,"Michael of Auchencrow, son of Edward",,M,0,1,1,0,1,1,3
7967,"Richard, son of Robert son of Matthew of Auchencrow",,M,0,1,1,0,1,1,29
7970,"Robert, hopper of Coldingham",,M,1,1,2,1,1,2,3
7982,"Thomas, son of Robert son of Matthew of Auchencrow",,M,0,1,1,0,1,1,3
8010,"Richard Fleming ",,M,0,1,1,0,1,1,71
8049,"Juliana, daughter of Humphrey the smith of Auckland",,F,0,1,1,0,1,1,30
8061,"John de St Michael, knight",,M,0,1,1,0,1,1,68
8066,"Stephen, son of Swain of Ayton",,M,0,1,1,0,1,1,3
8070,"Ulkil, son of Uhtred ",,M,0,1,1,0,1,1,31
8072,"Elias, heir of Ulkil",,M,0,1,1,0,1,1,31
8073,"William, heir of Ulkil",,M,0,1,1,0,1,1,31
8074,"Thomas, heir of Ulkil",,M,0,1,1,0,1,1,31
8085,"Waltheof, son of William of Ayton",,M,0,1,1,0,1,1,32
8142,"Alice, wife of Robert son of Maurice of upper Ayton",,F,0,1,1,0,1,1,3
8145,Richard Francis of Ayton (the Frenchman),,M,0,1,1,0,1,1,3
8171,"John Purroc, son of William Scott of Coldingham",,M,0,1,1,0,1,1,3
8172,Adam de Camera,,M,1,1,2,1,1,2,3
8174,Robert Purroc,,M,0,1,1,0,1,1,33
8208,Bertram of Benistun,,M,1,1,2,1,1,2,3
8225,Humphrey del Bois,,M,0,1,1,0,1,1,67
8245,Roger Francis (the Frenchman) (son of William),,M,0,1,1,0,1,1,67
8272,Uhtred of Grubbit,,M,0,1,1,0,1,1,71
8275,Robert of Barnoldby,,M,0,1,1,0,2,2,71
8277,"Simon, son of Uhtred of Grubbit",,M,0,1,1,0,1,1,71
8303,Daniel of Dowane,,M,0,1,1,0,2,2,72
8306,Robert of Dowane,,M,0,1,1,0,2,2,72
8497,"Richard, master of order of Sempringham",,M,0,1,1,0,1,1,66
8523,Henry of Anstruther (II),,M,0,1,1,0,1,1,9
8527,"Peter of Ashby, son of William of Ashby ",,M,0,1,1,0,4,4,9
8621,Roger of Auldhouse,,M,0,1,1,0,1,1,66
8670,"Alexander, son of Richard messenger of Glasgow",,M,1,1,2,1,1,2,7
8709,"John, son of Reginald Crawford",,M,0,1,1,0,1,1,1
8740,Unknown rectors of Keith,,M,0,1,1,0,1,1,69
8776,"Ranulf Corbet, master of Templars",,M,0,1,1,0,1,1,34
8794,"Christiana or Christina, daughter of William de Valognes, wife of Peter de Maule",,F,0,1,1,0,1,1,73
8832,"David, doorward (FIF)",,M,0,1,1,0,1,1,73
8838,"Emma, wife of Ralph de Burneville",,F,0,1,1,0,1,1,72
8920,"John Malherbe (I), lord of Morham",,M,0,1,1,0,5,5,1
8956,"Robert de Chartres, son of Thomas",,M,0,1,1,0,1,1,72
9005,"William, son of Ketill (in Perth)",,M,0,1,1,0,1,1,73
9022,"Robert, son of Walter Corbet",,M,0,1,1,0,1,1,71
9055,"Christiana, wife of Michael of Makerstoun",,F,0,1,1,0,1,1,72
9058,Walter son of Robert of Shotton,,M,0,1,1,0,1,1,72
9092,"Cecilia, daughter of Eschina of Mow",,F,0,1,1,0,3,3,72
9129,David of Houburne,,M,0,1,1,0,2,2,72
9132,Robert de Pesale,,M,0,1,1,0,2,2,72
9133,"Mabel, mother of Susanna, wife of Robert de Pesale",,F,0,1,1,0,1,1,72
9135,Matilda of the River,,F,0,1,1,0,1,1,72
9136,Hugh Mulard,,M,0,1,1,0,2,2,72
9137,Walter son of Baldwin (BWK),,M,0,1,1,0,2,2,72
9139,Walter son of Ralph of Essex,,M,0,1,1,0,2,2,72
9140,"Matilda, daughter of Aliz of Tweedmouth",,F,0,1,1,0,2,2,72
9142,"Seroc, daughter of Alice of Tweedmouth",,F,0,1,1,0,2,2,72
9144,"Christina, daughter of Alice of Tweedmouth",,F,0,1,1,0,2,2,72
9145,"Gunnhild, daughter of Alice of Tweedmouth",,F,0,1,1,0,2,2,72
9158,"Adam, son of Udding of Berwick",,M,0,1,1,0,1,1,72
9160,"Margaret, daughter of Adam son of Udding",,F,0,1,1,0,1,1,3
9239,"Adam, son of Serlo of Edinburgh",,M,0,1,1,0,1,1,68
9274,William of Alwinton,,M,0,1,1,0,1,1,71
9294,Robert of Pollok/Stenton (son of Fulbert),,M,0,1,1,0,2,2,71
9297,"Robert/Robin, son of Robert of Pollok/Stenton",,M,0,1,1,0,1,1,66
9351,"Godfrey de Ros, knight, sheriff (son of Godfrey)",,M,0,1,1,0,1,1,66
9425,"Walter Frebern ",,M,0,1,1,0,1,1,3
9489,"Alexander of Dunoon, knight",,M,0,1,1,0,1,1,66
9499,"John Erskine (I), knight",,M,0,1,1,0,1,1,35
9524,"Ralph of Kinnaird, son of Richard",,M,0,1,1,0,1,1,36
9619,Hugh Lorens,,M,0,1,1,0,1,1,72
9621,Ada Fraser,,F,0,1,1,0,1,1,72
9634,"Hervey, son of Philip, marischal (Keith)",,M,0,1,1,0,2,2,72
9697,"Alice Gordon, daughter of Thomas",,F,0,1,1,0,1,1,72
9713,Thomas Gordon (son of Richard),,M,0,1,1,0,1,1,72
9753,"John of Keith, marischal (son of Hervey)",,M,0,1,1,0,1,1,70
9807,Henry of Winton,,M,0,1,1,0,1,1,73
9867,"Hugh Murray, son of Augustine, knight (LAN)",,M,0,1,1,0,1,1,70
9870,"John Murray, knight (son of Malcolm Murray)",,M,0,1,1,0,2,2,89
9874,Simon of Balram,,M,0,1,1,0,1,1,73
9963,"Robert de l'Isle, knight (son of Robert)",,M,0,1,1,0,1,1,67
9973,Walter of Prenderguest,,M,1,1,2,1,2,3,3
9977,Robert of Hatley,,M,0,1,1,0,1,1,3
9997,Mauricius (Murdoch) Akarsan,,M,0,1,1,0,1,1,9
10003,Andrew of Kirkconnell (son of Robert),,M,0,1,1,0,2,2,75
10011,Andrew Maunsel (late 12C-early 13C),,M,0,1,1,0,1,1,72
10096,"Walter Lindsay (VI), son of David of Barnweill",,M,0,1,1,0,1,1,66
10098,Richard Scot,,M,0,1,1,0,1,1,72
10226,Adam of Crosbie,,M,0,1,1,0,1,1,67
10257,"William Avenel, son of Gilbert Avenel",,M,0,1,1,0,1,1,48
10258,"Matilda, wife of William Avenel",,F,0,1,1,0,1,1,48
10264,"Richard of Stickley, lord of Blebo",,M,0,1,1,0,1,1,9
10286,"Alexander, son of William son of Edgar",,M,0,1,1,0,1,1,72
10287,"Isolde, daughter of Anselm of Mow",,F,0,1,1,0,2,2,72
10323,"Warin, son of Robert English",,M,0,1,1,0,1,1,73
10333,"Alexander of Chatto, constable of Roxburgh",,M,0,1,1,0,1,1,71
10338,"Luke, son of Theobald",,M,0,1,1,0,3,3,67
10400,"Agnes Avenel, daughter of Laurence Avenel",,F,0,1,1,0,1,1,67
10402,"William of Alwinton, son of William",,M,0,1,1,0,1,1,71
10430,"William, son of Aldred of Bruckley",,M,0,1,1,0,1,1,71
10457,William de Beauair,,M,0,1,1,0,1,1,73
10474,"Alice, wife of Richard Scot of Mow",,F,0,1,1,0,1,1,72
10480,"Adam of Burn, son of Adam of Burn",,M,0,1,1,0,1,1,66
10481,"Margery, wife of Adam of Burn",,F,0,1,1,0,1,1,66
10484,Joan Wishart,,F,0,1,1,0,1,1,72
10502,Elmer Scot of Mow,,M,0,1,1,0,1,1,72
10504,"Christiana, wife of Elmer Scot of Mow",,F,0,1,1,0,1,1,72
10532,"Matilda, wife of Richard of Lincoln (Junior)",,F,0,1,1,0,1,1,72
10557,"William, son of Philip of Greenrig",,M,1,1,2,1,1,2,72
10575,"Alexander Baird, knight, lord of Edlemyston",,M,0,1,1,0,1,1,37
10579,"Richard de Beaumont ",,M,0,1,1,0,1,1,38
10637,"Hugh, son of John son of Hugh of Redden",,M,1,1,2,1,1,2,72
10659,"Heloise, daughter of Nicholas de CÄŹĹĽËťtentin",,F,0,1,1,0,1,1,72
10665,"Ada, wife of William of Halkerston",,F,0,1,1,0,1,1,72
10666,"Emma, wife of Richard of Halkerston",,F,0,1,1,0,1,1,72
10667,"Helen, wife of John Montgomery",,F,0,1,1,0,1,1,72
10700,"David, son of Truite",,M,0,1,1,0,1,1,72
10721,"Robert, son of Robert son of Warnebald",,M,1,1,2,1,1,2,72
10734,"Alan, son of Elias of Brotherstone",,M,0,1,1,0,1,1,9
10737,"Simon of the Wardrobe ",,M,1,1,2,1,1,2,9
10746,William of Burncastle,,M,0,1,1,0,1,1,9
10750,Peter of Balfour,,M,0,1,1,0,1,1,9
10752,"Patrick, son of Walter of Lennel, knight",,M,0,1,1,0,1,1,72
10768,"Adam, son of Patrick of Carberry ",,M,0,1,1,0,2,2,73
10781,John of Carberry,,M,0,1,1,0,1,1,73
10803,William of Smeaton,,M,1,1,2,1,1,2,73
10805,"John, son of Gilbert of Carberry ",,M,0,1,1,0,1,1,73
10847,"Hugh Ridel (II), lord of Cranstoun",,M,0,1,1,0,1,1,1
10866,Nicholas of Smeaton,,M,0,1,1,0,1,1,73
10877,Gilbert of Cleish,,M,0,1,1,0,1,1,73
10892,"Hugh Emme/ Heem, son of Constance",,M,1,1,2,1,2,3,68
10893,"William, son of Henry of Craigmillar ",,M,0,1,1,0,1,1,73
10909,"Gilbert, son of Rory of Crambeth",,M,0,1,1,0,1,1,73
10918,"Walter, son of Patrick of Ryedale",,M,0,1,1,0,5,5,71
10919,"Agnes, daughter of John of Cramond",,F,0,1,1,0,1,1,73
10924,"Walter, son of William of Wiston, knight",,M,0,1,1,0,1,1,72
10925,"Matilda Corbet ",,F,0,1,1,0,1,1,71
10938,Henry of Belton,,M,0,1,1,0,1,1,71
10942,Heirs of Robert Barclay and Cecilia his wife,,M/F,0,1,1,0,1,1,71
10957,"Richard, son of Richard Crass (the Fat) ",,M,0,1,1,0,1,1,73
10961,"John Crass (the Fat), son of Richard Crass ",,M,0,1,1,0,1,1,73
10963,"Isabel, wife of John Crass",,F,0,1,1,0,1,1,73
10965,Thomas of Cranston,,M,0,1,1,0,1,1,70
10985,"Reginald Gaillard ",,M,0,1,1,0,1,1,73
10986,"Agnes, wife of Thomas of Restalrig",,F,0,1,1,0,1,1,70
10990,Hugh Breton/Brito,,M,0,1,1,0,1,1,67
10993,"John Gaillard ",,M,0,1,1,0,2,2,73
11002,"Henry, lord of Wiston, knight",,M,0,1,1,0,1,1,72
11011,Robert of Hillcrest,,M,0,1,1,0,1,1,72
11016,"William of the hill of Midlem, son of Watheof son of Aldwin",,M,0,1,1,0,1,1,72
11019,Alan de Sarcrino,,M,0,1,1,0,1,1,72
11026,"Arnold, son of Peter of Kelso",,M,0,1,1,0,1,1,72
11046,"Andrew, son of William, dyer",,M,0,1,1,0,1,1,72
11047,"Senegle, wife of Andrew son of William",,F,0,1,1,0,1,1,72
11056,"Elias, brother of Bishop Jocelin",,M,0,1,1,0,1,1,72
11059,Adam de Port,,M,0,1,1,0,1,1,72
11084,"Adam, son of William Bruning",,M,0,1,1,0,1,1,39
11085,"Beatrice, daughter of Robert Scrype",,M,0,1,1,0,1,1,39
11098,"Constantine, son of Adam son of Eadwulf ",,M,1,1,2,1,2,3,1
11113,"Herbert, son of Herbert de Camera",,M,0,1,1,0,1,1,68
11126,"Malcolm, king's armour-bearer",,M,0,1,1,0,1,1,68
11156,"Alwine, son of Duncan, of Foffarty",,M,0,1,1,0,1,1,40
11168,"Peter Hay, knight",,M,0,1,1,0,1,1,73
11170,"Robert, son of Robert of Throckley",,M,0,1,1,0,1,1,72
11171,Robert of Throckley,,M,0,1,1,0,1,1,72
11183,"Walter, son of Everard of Pencaitland",,M,0,1,1,0,1,1,72
11206,Falletauch (in Drumcarro),,M,0,1,1,0,1,1,74
11214,"Richard of Fans, son of Nicholas (late 13C)",,M,0,1,1,0,1,1,9
11223,"William de Ferrers (d.1325), son of William de Ferrers",,M,0,1,1,0,1,1,73
11225,"Eda, daughter of Nicholas of Fans",,F,0,1,1,0,1,1,9
11227,"William Gillies ",,M,0,1,1,0,1,1,9
11241,"Peter Haig, lord of Bemersyde (mid 13C)",,M,0,1,1,0,1,1,9
11244,"John de Haig, son of Peter, lord of Bemersyde",,M,0,1,1,0,1,1,9
11247,"Alexander of Dalmahoy, knight",,M,0,1,1,0,1,1,1
11254,"William Spurr, burgess of Berwick ",,M,0,1,1,0,1,1,9
11273,"Adam, carpenter ",,M,0,1,1,0,1,1,66
11276,"Thomas the carpenter, son of Adam the carpenter ",,M,0,1,1,0,1,1,66
11280,Peter de Castro,,M,0,1,1,0,1,1,7
11297,"Margery, wife of Walter of Longforgan the burgess of Berwick",,F,0,1,1,0,2,2,72
11298,"Walter of Longforgan, burgess of Berwick",,M,0,1,1,0,1,1,72
11310,John of Grantham,,M,0,1,1,0,1,1,72
11312,"Thomas de Bataille, grieve of Berwick",,M,0,1,1,0,1,1,72
11313,"William de Bataille, burgess of Berwick",,M,0,1,1,0,1,1,72
11327,"Roger Barclay, knight (mid 13C)",,M,0,1,1,0,2,2,67
11376,Hugh Cnot (Knott),,M,0,1,1,0,1,1,73
11398,Thomas of Craigie,,M,0,1,1,0,1,1,66
11411,Andrew of Dalreoch,,M,0,1,1,0,1,1,89
11463,"William Hay (II), lord of Aithmuir (son of William)",,M,0,1,1,0,2,2,74
11466,William of Gaston/Galliston,,M,0,1,1,0,1,1,41
11467,"John Hay, lord of Balcomie",,M,1,1,2,1,1,2,41
11502,"Simon, son of Everard ",,M,0,1,1,0,1,1,74
11518,Michael of Inchture,,M,0,1,1,0,1,1,74
11521,"John de Gillebar ",,M,0,1,1,0,1,1,74
11533,William de Campania (Champagne),,M,0,1,1,0,1,1,67
11537,Richard Hay (Kay?),,M,0,1,1,0,1,1,74
11543,"Juliana de Lascelles, wife of John Hay",,F,0,1,1,0,1,1,67
11549,Walter Hamill,,M,0,1,1,0,1,1,1
11573,Henry Graham (son of Henry son of Peter),,M,0,1,1,0,1,1,66
11583,"Christiana, daughter of Cairell the judex",,F,0,1,1,0,1,1,92
11585,"Eve of Carsegownie, daughter of Walter the lorimer",,F,0,1,1,0,1,1,42
11601,Philip d'Eu,,M,0,1,1,0,1,1,70
11603,"Roger, son of Philip d'Eu",,M,0,1,1,0,1,1,43
11610,"John of Johnstone, knight",,M,0,1,1,0,1,1,67
11611,Patrick of Craigie,,M,0,1,1,0,1,1,44
11618,"Roger of Reston (13C, father of Elias)",,M,0,1,1,0,1,1,3
11619,"David de St Michael ",,M,0,1,1,0,1,1,67
11625,Alan of Caundle,,M,0,1,1,0,1,1,3
11626,"Bertram, son of Robert Cook of Coldingham ",,M,1,1,2,1,3,4,3
11642,"William, son of the Chanter ",,M,1,1,2,1,2,3,3
11650,"William, son of William the Chanter ",,M,0,1,1,0,1,1,45
11652,"Augustine Cissor (father of Alice, husband of Agnes)",,M,0,1,1,0,1,1,3
11653,"Agnes Cantor, sister of William, son of William the Chanter",,F,0,1,1,0,1,1,3
11655,"Thomas of Coffin, knight",,M,0,1,1,0,1,1,68
11659,"Simon SunglÄŹĹĽËť, son of Edward the constable",,M,0,1,1,0,1,1,68
11664,Mariota of Chirnside,,F,0,1,1,0,1,1,3
11666,"Patrick, son of Mariota of Chirnside",,M,0,1,1,0,1,1,3
11667,"Gilbert of Downhill (Dondowan), son of Gilbert",,M,0,1,1,0,1,1,89
11690,"Christiana, wife of Constantine of Coldingham",,F,0,1,1,0,2,2,3
11691,"Samson, hunter (BWK)",,M,0,1,1,0,2,2,71
11697,"John, son of Robert Russell of Duncanlaw",,M,0,1,1,0,1,1,70
11698,Walter Champneys of Carrick,,M,0,1,1,0,1,1,71
11709,Gillespie mac Kennedy,,M,0,1,1,0,1,1,71
11752,"Aldan, brewer (Coldingham)",,M,0,1,1,0,1,1,3
11768,"Amabel, wife of Alan the carpenter (Coldingham)",,F,1,1,2,1,1,2,3
11779,"Thomas, son of Robert the steward",,M,0,1,1,0,1,1,3
11793,"Roger, son of Ralph grieve of Coldingham ",,M,0,1,1,0,1,1,73
11798,John of Cockburn,,M,0,1,1,0,2,2,67
11806,"Margaret, wife of John the page of Coldingham",,F,0,1,1,0,1,1,46
11809,"Richard Ploume ",,M,0,1,1,0,1,1,3
11817,"John Ploume, son of Richard ",,M,0,1,1,0,1,1,3
11851,"Henry, son of Conan",,M,0,1,1,0,1,1,72
11875,"William Purves ",,M,0,1,1,0,1,1,71
11877,"Thomas, son of Walter (II) of Darnchester",,M,0,1,1,0,1,1,72
11884,"Richard, son of Hugh cook of Darnchester",,M,0,1,1,0,1,1,72
11903,"Mariota, lady of Home, wife Patrick Edgar",,F,0,1,1,0,1,1,72
11935,William of Halton (brother of Ranulf),,M,0,1,1,0,1,1,72
11964,"Henry of Graham, lord of Hutton",,M,0,1,1,0,1,1,67
11967,Nicholas Graham (d.1306),,M,0,1,1,0,1,1,71
11987,"Adam, son of Roger of Edington ",,M,0,1,1,0,1,1,3
12018,Robert of Dundonald,,M,0,1,1,0,1,1,67
12045,"John of Stevenston, son of Archibald of Gullane",,M,1,1,2,2,1,3,68
12046,"Christiana, wife of Gilbert Fraser (12C)",,F,0,1,1,0,1,1,77
12049,Ralph of Yetholm,,M,0,1,1,0,1,1,77
12050,"Emma, daughter of Robert Byboyis",,F,0,1,1,0,1,1,67
12068,"John, son of Gunnhild ",,M,1,1,2,1,1,2,3
12099,"John, hopper (Coldingham)",,M,0,1,1,0,1,1,3
12106,"Patrick, son of Robert the hopper (Coldingham)",,M,0,1,1,0,1,1,3
12107,"John, son of Richard of Invertiel",,M,1,1,2,1,1,2,74
12114,William of Lovelin,,M,0,1,1,0,1,1,3
12122,"Laurence, son of Patrick, knight",,M,0,1,1,0,1,1,69
12135,Matthew of Howburn,,M,0,1,1,0,1,1,3
12144,Richard of Banchory,,M,0,1,1,0,1,1,67
12148,Gilbert of Cassingray,,M,0,1,1,0,1,1,67
12162,John of Jedburgh,,M,0,1,1,0,1,1,3
12163,"Mariota, daughter of Maurice of Ayton ",,F,0,1,1,0,1,1,3
12167,"John de Neville ",,M,0,1,1,0,1,1,47
12179,"John, son of Hervey, ab of Falkirk",,M,0,1,1,0,1,1,68
12226,"Robert Griffin ",,M,0,1,1,0,2,2,67
12227,"Mabel, wife of Robert Griffin",,F,0,1,1,0,2,2,67
12237,"Richard, son of Reginald of Oldhamstocks ",,M,0,1,1,0,1,1,3
12279,"Richard, nephew of David, marischal",,M,0,1,1,0,1,1,72
12280,"Moses, arblaster (crossbowman)",,M,0,1,1,0,1,1,71
12282,"Grim, son of Guy",,M,0,1,1,0,1,1,71
12315,Henry son of Thurstan son of Leving,,M,0,1,1,0,1,1,71
12316,"Mary, wife of Henry son of Thurston",,F,0,1,1,0,1,1,71
12317,Rory mac Gillespie,,M,0,1,1,0,1,1,71
12318,"Christiana, wife of Rory (Roderic) mac Gillespie",,F,0,1,1,0,1,1,71
12329,"Eve, wife of Robert de Quincy",,F,1,1,2,1,1,2,71
12330,"Unknown, landholder in Stenton",,M,0,1,1,0,1,1,71
12334,Patrick of Whitton,,M,0,1,1,0,1,1,71
12343,"Ralph, son of Philip ",,M,0,1,1,0,1,1,3
12366,"Simon, son of Elias of Prenderguest ",,M,1,1,2,1,3,4,3
12382,"Patrick, son of Patrick Long, sergeant of West Reston",,M,0,1,1,0,2,2,3
12388,"Nicholas, son of Roland son-in-law of Nicholas de CÄŹĹĽËťtentin",,M,0,1,1,0,2,2,71
12389,William Wallace of Stenton,,M,0,1,1,0,1,1,71
12409,"Isabel, daughter of Robert son of Fulbert of Stenton",,F,0,1,1,0,1,1,71
12417,Richard Kay,,M,0,1,1,0,1,1,74
12436,Hugh of Kilmany,,M,0,1,1,0,1,1,71
12444,William of Kirkconnell (son of Michael),,M,0,1,1,0,3,3,75
12453,"Andrew of Kirkconnell, squire (son of Michael)",,M,0,1,1,0,2,2,75
12525,"Margery, wife of Malcolm of Kilspindie",,F,0,1,1,0,1,1,67
12546,"William, son of Patrick of Kintillo",,M,0,1,1,0,1,1,74
12586,David Oliphant (13C),,M,0,1,1,0,1,1,70
12604,"Cecilia, wife of John of Partick",,F,0,1,1,0,1,1,66
12621,"Liulf, son of Liulf of Preston ",,M,1,1,2,1,1,2,1
12623,"Theobald, son of William (Clement)",,M,0,1,1,0,1,1,67
12625,"John White, son of John son of Gilleburn ",,M,0,1,1,0,1,1,1
12692,Walter de Pershay (d.1289),,M,0,1,1,0,2,2,48
12699,"Simon, son of Simon of Orrock ",,M,0,1,1,0,1,1,73
12737,Peter of Corrie,,M,0,1,1,0,1,1,71
12745,"Helen, daughter of Roger the porter",,F,0,1,1,0,1,1,67
12787,Adam Camoys,,M,0,1,1,0,1,1,69
12794,Peter of Preston,,M,0,1,1,0,1,1,66
12799,Benedict of Pennington,,M,0,1,1,0,1,1,49
12800,"Maldred, brother of Benedict of Pennington",,M,0,1,1,0,1,1,49
12807,"Hugh Crawford (II), son of Hugh Crawford (1250s-70s)",,M,0,1,1,0,1,1,50
12826,"Robert Fleming, lord of Wardhouse",,M,0,1,1,0,1,1,51
12853,"Ralph Noble, son of Ralph",,M,0,1,1,0,1,1,66
12855,"Alina, wife of Hugh de Normanville",,F,0,1,1,0,1,1,71
12884,"Everard, baker of Lauder ",,M,0,1,1,0,1,1,9
12896,"Richard, son of Gillian of Lamberton ",,M,0,1,1,0,1,1,52
12906,"Laurence, son of  William son of Jocelin ",,M,0,1,1,0,1,1,3
12915,"Alexander, son of Henry son of Samson",,M,0,1,1,0,1,1,9
12924,"William Ramsay, lord of Dalhousie",,M,0,1,1,0,1,1,53
13073,Aed (Eggu) the Red,,M,0,1,1,0,1,1,73
13081,"Isabel, wife of Robert of Stenton/Pollok",,F,0,1,1,0,1,1,72
13135,"Geoffrey, son of Waltheof of Lilliesleaf",,M,0,1,1,0,3,3,71
13151,"Geoffrey, cook of Whitton",,M,0,1,1,0,1,1,71
13157,William of Morthington,,M,0,1,1,0,1,1,71
13158,"Adam, violer (BWK)",,M,0,1,1,0,1,1,71
13159,"Anne, wife of Adam the violer",,F,0,1,1,0,1,1,71
13185,William of Lilliesleaf,,M,0,1,1,0,1,1,71
13222,John of North Berwick,,M,0,1,1,0,2,2,71
13223,"Philip, son of Philip of Pitcox",,M,0,1,1,0,2,2,71
13233,"Alexander Seton, son of Saer Seton",,M,0,1,1,0,1,1,71
13242,Ancestors of Richard Wallace,,M/F,0,1,1,0,1,1,71
13337,"Angus, son of Duncan son of Fearchar ",,M,0,1,1,0,2,2,66
13345,"Thomas, son of Gilbert son of Laysing of Lessudden",,M,0,1,1,0,1,1,69
13359,"Matilda, wife of Dougal son of Christian",,F,0,1,1,0,1,1,66
13372,"Matilda, sister of Christina HosÄŹĹĽËť ",,F,0,1,1,0,1,1,66
13393,"Geoffrey, son of Geoffrey of Clifton",,M,0,1,1,0,1,1,71
13401,"Christina, daughter of William son of Adam of Hassendean",,F,0,1,1,0,1,1,54
13413,William of Landells,,M,0,1,1,0,1,1,71
13417,John of Landells,,M,0,1,1,0,1,1,71
13419,Richard of Rule,,M,0,1,1,0,1,1,71
13499,"William, son of Walter son of Patrick of Ryedale",,M,0,1,1,0,2,2,71
13518,"Philip, son of Philip de Vermelles",,M,0,1,1,0,1,1,1
13542,"Adam, son of Adam of Durham",,M,0,1,1,0,1,1,71
13550,"Adam of Heiton, master",,M,0,1,1,0,1,1,71
13551,"Helen, wife of Adam of Heiton",,F,0,1,1,0,1,1,71
13557,Richard of Heiton,,M,0,1,1,0,2,2,71
13569,"Robert, son of Alexander of London",,M,0,1,1,0,1,1,71
13598,William de Quarrantilly,,M,0,1,1,0,1,1,9
13606,"Walter of Kilham, son of Robert of Scotton",,M,0,1,1,0,1,1,71
13612,Otto de Tilly,,M,0,1,1,0,1,1,9
13624,"Thomas of Kilham, son of Walter of Kilham",,M,0,1,1,0,1,1,71
13640,Thomas of Rawburn,,M,0,1,1,0,2,2,72
13647,"Godfrey, son of Thomas of Tynedale",,M,0,1,1,0,1,1,1
13658,"Robert de Muschamp, son of Robert de Muschamp",,M,0,1,1,0,3,3,71
13662,"Isabel, wife of Robert (I) of Roos",,F,0,1,1,0,1,1,68
13678,"William, son of Gamel of Twynholm",,M,0,1,1,0,2,2,68
13697,"Nicholas, weaver, burgess of Berwick",,M,0,1,1,0,2,2,71
13714,"Peter, son of Patrick, of Renton ",,M,0,1,1,0,1,1,3
13723,"Robert, son of Patrick, of Renton ",,M,0,1,1,0,1,1,3
13733,"Ralph of Echline, burgess of Haddington",,M,0,1,1,0,2,2,71
13798,"Malcolm, son of Malcolm son of Roger",,M,0,1,1,0,1,1,68
13820,"Floria, wife of Adam Quintin",,F,0,1,1,0,1,1,70
13892,"Richard Lovell, lord of Hawick",,M,0,1,1,0,1,1,73
13915,"William of Sprouston, chaplain",,M,1,1,2,2,1,3,71
13954,"Isabel, wife of William of Ryedale",,F,0,1,1,0,1,1,71
13988,"Dungal, son of Udard",,M,0,1,1,0,1,1,71
13997,"William, son of Ralph the Lardenar",,M,0,1,1,0,1,1,67
13998,"David, brother of William son of Ralph the Lardenar",,M,0,1,1,0,1,1,67
13999,Sons of William son of Ralph the Lardenar,,M,0,1,1,0,1,1,67
14000,"Unknown, heir of William son of Ralph the Lardenar",,M,0,1,1,0,1,1,67
14019,"Agnes, daughter of John, wife of Laurence of Elliston",,F,0,1,1,0,1,1,71
14031,"Amabel, wife of Thomas of Nisbet",,F,0,1,1,0,2,2,71
14051,"Alexander Jocelin, burgess of Peebles",,M,0,1,1,0,1,1,71
14053,"Mariota of the monks, wife of Nicholas the apothecary",,F,0,1,1,0,2,2,71
14056,"Eustace Broun, burgess of Berwick",,M,0,1,1,0,2,2,71
14058,Henry Graham (12C),,M,0,1,1,0,1,1,1
14064,Thomas (IV) of Moulton of Egremont (d.c.1321),,M,0,1,1,0,1,1,75
14099,Robert de Ros (KCD),,M,0,1,1,0,1,1,68
14101,"Waleran, son of Ralph",,M,0,1,1,0,1,1,1
14133,"Constantine of Lochore (III), son of Constantine, sheriff",,M,0,1,1,0,1,1,73
14166,Walter of Lundin (II),,M,0,1,1,0,1,1,74
14172,"Margaret, wife of Bernard of Ripley",,F,0,1,1,0,1,1,75
14206,John de Vaux of Gilsland (son of Robert),,M,0,1,1,0,1,1,9
14211,Alan de Vieuxpont (early 13C),,M,0,1,1,0,1,1,9
14212,"Robert de Vieuxpont, son of Alan",,M,0,1,1,0,2,2,9
14222,Simon of Swinwood,,M,0,1,1,0,1,1,3
14233,"Ragnhild of Yetholm, wife of Ralph of Yetholm",,F,0,1,1,0,1,1,77
14235,"Thomas of Yester, son of Ralph",,M,0,1,1,0,1,1,68
14285,"Amabel, wife of Nicholas de Vieuxpont",,F,0,1,1,0,1,1,70
14292,"Robert de Vieuxpont, son of Ivo",,M,0,1,1,0,1,1,9
14294,"Adam, nepos of R. de Warenne",,M,0,1,1,0,1,1,67
14313,Christiana of Windsor,,F,0,1,1,0,1,1,77
14349,"William, son of Robert of West Reston ",,M,0,1,1,0,1,1,67
14365,"Gilbert, son of William son of Aldan, of Rothbury ",,M,0,1,1,0,1,1,3
14378,Hugh de Mortimer (fl.1225-35),,M,0,1,1,0,1,1,73
14418,"William Maitland, son of Richard",,M,0,1,1,0,2,2,9
14424,"Hugh de Moreville (I, II or III)",,M,0,1,1,0,1,1,9
14429,"Richard, son of Jordan Mus ",,M,0,1,1,0,1,1,3
14450,"Patrick, son of Elias Dunning ",,M,0,1,1,0,2,2,3
14451,Walter of Mulcaster,,M,0,1,1,0,1,1,9
14456,"Walter, son of Stephen Melville the clerk",,M,0,1,1,0,1,1,67
14459,"Thomas Malherbe (III), lord of Morham",,M,0,1,1,0,1,1,1
14481,Thomas Maule,,M,0,1,1,0,1,1,1
14485,"Thomas Modok ",,M,0,1,1,0,1,1,55
14497,"Amfred, horn-blower of Lanark",,M,0,1,1,0,1,1,9
14502,"Laurence le Stater, burgess of Berwick",,M,0,1,1,0,1,1,1
14508,"John, son of Geoffrey Lindsay, burgess of Berwick",,M,0,1,1,0,1,1,1
14522,"Reginald, burgess of Dumbarton",,M,0,1,1,0,1,1,9
14525,"Simon, son of Macbeth",,M,0,1,1,0,1,1,68
14542,"Henry Tendeman, merchant of Leith",,M,0,1,1,0,1,1,9
14543,"Matilda, wife of Henry Tendeman",,F,0,1,1,0,1,1,9
14577,Roger de Merlay (III) (d.1265),,M,0,1,1,0,1,1,73
14622,Philip de Munfichet (Muschet),,M,0,1,1,0,1,1,68
14623,"Anne, daughter of Colin Durward, wife of Philip de Munfichet",,F,0,1,1,0,1,1,68
14652,"Geoffrey Melville (II), son of Geoffrey (I)",,M,2,1,3,2,1,3,68
14660,"Donald mac Gilchrist, lord of Tarbert",,M,0,1,1,0,1,1,66
14687,"Robert, son of William of Moffat",,M,0,1,1,0,1,1,75
14694,"John  Mauleverer ",,M,0,1,1,0,1,1,66
14696,"Gilchrist, son of Malcolm MacNachtan",,M,1,1,2,1,2,3,67
14704,Roger Grindegret of Dumfries,,M,0,1,1,0,1,1,69
14714,William Grindegreth of Dumfries,,M,0,1,1,0,1,1,77
14724,"Eda, wife of William son of Ketell of Perth",,F,0,1,1,0,1,1,73
14727,"Wimarc, daughter of William son of Ketell of Perth",,F,0,1,1,0,1,1,73
14731,"John, son of David, burgess of Perth",,M,0,1,1,0,1,1,73
14735,John Ylbaren of Perth,,M,0,1,1,0,1,1,73
14769,"Aed, son of Malcolm MacNachtan",,M,0,1,1,0,1,1,67
14771,Duncan of Melginch,,M,0,1,1,0,1,1,67
14795,"Hawise, wife of Walter baker of Perth",,F,0,1,1,0,1,1,67
14796,"Walter, baker of Perth ",,M,0,1,1,0,1,1,67
14804,William de Memil,,M,0,1,1,0,1,1,70
14816,"Walter of Soutra, burgess of Berwick",,M,0,1,1,0,1,1,70
14824,"Alice of By, wife of William of Chirnside",,M,0,1,1,0,1,1,70
14837,Robert de Mayle (Maille),,M,0,1,1,0,2,2,72
14855,"Roger, son of William of Bassendean",,M,0,1,1,0,1,1,72
14856,"Alice, wife of Roger son of William",,F,0,1,1,0,1,1,72
14877,Robert of Miningsby,,M,0,1,1,0,1,1,56
14899,"Thomas of Monymusk, knight",,M,0,1,1,0,1,1,66
14995,"Peter, son of John of Linlithgow",,M,0,1,1,0,1,1,69
14998,"John of the River, burgess of Dundee",,M,0,1,1,0,1,1,57
15006,"Hervey, son of Humphrey Wllebeter of Forfar",,M,0,1,1,0,1,1,71
15007,"Heloise, sister of Hervey, son of Humphrey",,F,0,1,1,0,1,1,71
15028,"Pain, goldsmith of Edinburgh",,M,0,1,1,0,1,1,73
15040,"Martin, goldsmith, burgess of Aberdeen",,M,0,1,1,0,1,1,92
15099,Peter Ru[...] of Aberdeen,,M,0,1,1,0,1,1,58
15152,Hugh Malherbe (III),,M,0,1,1,0,1,1,59
15157,"Elmer, son of Robert de St Michael ",,M,0,1,1,0,1,1,9
15164,"Henry, son of William of Saltoun",,M,0,1,1,0,1,1,9
15168,Henry Stylle of Saltoun,,M,0,1,1,0,1,1,9
15171,"Orable, sister of Hugh Sai",,F,0,1,1,0,1,1,9
15177,Niall or Nigel of Scotstoun,,M,0,1,1,0,1,1,73
15197,"Emma, wife of William of Smeaton",,F,0,1,1,0,1,1,73
15223,"Patrick, son of Gilbert of Southwick",,M,0,1,1,0,1,1,75
15224,"Edward of Whitewell, clerk, rector",,M,0,1,1,0,1,1,70
15253,"Katherine, daughter of Walter of Wells",,F,0,1,1,0,1,1,69
15378,"Adam de Cardelechan ",,M,0,1,1,0,1,1,66
15383,"John, canon of  Dalmilling Priory ",,M,0,1,1,0,1,1,66
15384,"Walter, canon of Dalmilling Priory ",,M,0,1,1,0,1,1,66
15409,"Adam, son of Duncan Gley, burgess of Aberdeen",,M,0,1,1,0,1,1,60
15498,"Patrick, abbot of Kelso (f.1258-60)",,M,0,1,1,0,1,1,9
15574,Sons of Thor son of Swain,,M,0,1,1,0,1,1,68
15614,"Adam, son of Roger Spoth",,M,0,1,1,0,1,1,3
15624,Chapter of St Mary's of St Andrews,,I,0,1,1,0,1,1,67
15665,"Matilda, wife of John the furber (Perth)",,F,0,1,1,0,1,1,73
15680,"William, abbot of Scone (fl.1273x84)",,M,0,1,1,0,1,1,67
15684,Philip Chylde of Plenderleith,,M,0,1,1,0,1,1,61
15685,"Marion, wife of Philip Chylde of Plenderleith",,F,0,1,1,0,1,1,61
15734,"Race, son of Malger",,M,0,1,1,0,1,1,73
15790,"Bertram, son of Henry of Ulston",,M,0,1,1,0,1,1,62
15803,"Isabel, countess of Carrick",,F,0,1,1,0,1,1,66
15860,"William Cissor ",,M,0,1,1,0,1,1,67
15862,"Hamund, son of Ralph the clerk ",,M,0,1,1,0,1,1,67
15919,"John of Ramsay, lord of Gladney",,M,0,1,1,0,1,1,63
16011,"John Prat, knight",,M,0,1,1,0,1,1,64
16023,Roger Bertram (I),,M,0,1,1,0,1,1,9
16133,"John Maitland, son of Robert Maitland, lord of Thirlestane",,M,0,1,1,0,1,1,9
16157,"John Gifford, lord of Yester ",,M,0,1,1,0,1,1,9
16159,"William Abernethy (I, II or III)",,M,0,1,1,0,2,2,9
16784,"John, earl of Caithness",,M,0,1,1,0,1,1,68
17637,"Duncan, son of Gilla Micheil mac Eadwulf",,M,0,1,1,0,1,1,66
17644,"Finlay, jagger, son of Ralph, jagger",,M,0,1,1,0,2,2,65
17907,William of Kinmonth,,M,0,1,1,0,1,1,68
19456,Adam of Rule,,M,0,1,1,0,1,1,72
22720,"John of Landells, knight (late 13C)",,M,0,1,1,0,2,2,71
834,"Simon de Tosny, bishop of Moray (d.1184)",,M,1,0,1,2,0,2,68
1149,Moray Cathedrals (Elgin/Spynie),,I,7,0,7,9,0,9,68
1327,"Ranulf, falconer, son of Walter of Lowthorpe",,M,1,0,1,1,0,1,68
976,Ralph Ruffus,,M,1,0,1,1,0,1,68
5488,"Gilbert or Gilla Brigte, brother of Earl Gilchrist of Angus",,M,1,0,1,1,0,1,68
617,Bishopric of Glasgow,,I,1,0,1,1,0,1,68
1302,"Church of St Cuthbert, Kirkcudbright",,I,1,0,1,1,0,1,68
1303,"Church of St Oswald the martyr, Kelton",,I,1,0,1,1,0,1,68
87,Holyrood Abbey (fd.1128),,I,49,0,49,97,0,97,68
1315,Robert of Newham,,M,1,0,1,1,0,1,68
293,Hospital of St Andrews,,I,7,0,7,11,0,11,68
1359,Burgesses of Arbroath,,M,1,0,1,1,0,1,68
1381,Hospital of Oldcambus,,I,2,0,2,2,0,2,3
1379,"Maurice or Murdoch, younger, earl of Menteith (d.1231x34)",,M,1,0,1,1,0,1,68
786,"Mauricius (Murdoch), elder, earl of Menteith (d.1213x34)",,M,1,0,1,1,0,1,68
278,Paisley Abbey (fd.1169),,I,84,0,84,159,0,159,66
667,North Berwick Priory,,I,17,0,17,25,0,25,73
710,"Mary, Blessed Virgin",,F,135,0,135,196,0,196,69
1370,Robert de Aubein,,M,2,0,2,2,0,2,71
1350,"Nicholas, son of Eilaf, king's baker",,M,1,0,1,1,0,1,68
1115,Inchaffray Abbey,,I,42,0,42,97,0,97,67
216,Coupar Angus Abbey (fd.1164),,I,67,0,67,112,0,112,74
1353,"Andrew, son of Uvieth",,M,1,0,1,1,0,1,68
1349,"John, the hermit (12C)",,M,1,0,1,1,0,1,68
1253,Burgesses of Ayr,,M,3,0,3,6,0,6,71
334,"William, son of Freskin, lord of Duffus (William I Freskin)",,M,2,0,2,2,0,2,68
1207,"Emma, maternal aunt of William of Gullane",,F,1,0,1,2,0,2,68
1205,"Nicholas, brother of William of Gullane",,M,1,0,1,2,0,2,68
1251,Bishops of Brechin,,M,1,0,1,1,0,1,68
1250,celi De of Brechin,,I,1,0,1,1,0,1,68
120,"Orm, son of Aed (Hugo), son of Gillemichel",,M,1,0,1,3,0,3,68
1256,"Thomas, priest, persona of Inverness",,M,1,0,1,1,0,1,68
726,Missenden Abbey,,I,2,0,2,2,0,2,68
1236,"Robert, chaplain of Countess Ada",,M,1,0,1,1,0,1,68
1237,"Matthew, son of Robert, king's chaplain",,M,1,0,1,1,0,1,68
846,Saint Thomas the Martyr,,M,3,0,3,4,0,4,68
250,Cambuskenneth Abbey (fd.c.1140),,I,38,0,38,65,0,65,68
1286,Ralph Graham,,M,1,0,1,2,0,2,68
1278,Lesmahagow Priory,,I,9,0,9,11,0,11,66
1255,"Church of St Mary, Inverness",,I,1,0,1,1,0,1,68
1270,Walter de la Carneille,,M,1,0,1,1,0,1,68
7266,"Gilchrist (II), son of Earl Gilbert of Strathearn",,M,2,0,2,2,0,2,71
1097,Burgesses of Inverness,,M,2,0,2,4,0,4,68
1275,Gilbert of Cathcart,,M,1,0,1,1,0,1,68
1260,John Waleram,,M,1,0,1,1,0,1,68
1470,Burgesses of Rutherglen,,M,1,0,1,1,0,1,68
1101,Kinloss Abbey (fd.1150),,I,13,0,13,16,0,16,69
1415,Haddington Priory,,I,3,0,3,4,0,4,73
186,Glasgow Cathedral,,I,35,0,35,64,0,64,66
914,Saint Kentigern,,M,24,0,24,43,0,43,66
8030,"Bertram Seton, son of Alexander Seton",,M,1,0,1,1,0,1,68
1103,William de Vescy (I) (d.1183),,M,1,0,1,1,0,1,68
138,Jedburgh Abbey (fd.c.1138),,I,16,0,16,21,0,21,73
1214,"Hospital of St Peter, York",,I,10,0,10,11,0,11,75
1487,Burgesses of Inverkeithing,,M,3,0,3,5,0,5,71
1098,Burgesses of Moray,,M,1,0,1,4,0,4,68
1351,Eilaf (father of Nicholas the baker),,M,1,0,1,1,0,1,68
1169,Burgesses of Aberdeen,,M,3,0,3,4,0,4,68
773,"Henry, master, persona of Inverkeilor (fl.1173x99)",,M,2,0,2,2,0,2,68
820,"Hugh of Roxburgh, bishop-elect of Glasgow (d.1199)",,M,1,0,1,1,0,1,68
1042,Philip of Seton,,M,1,0,1,1,0,1,68
1140,"James of Perth, son of Simon of Inchyra",,M,2,0,2,2,0,2,68
1442,"Walkelin, king's brewer",,M,1,0,1,1,0,1,68
1385,"William, helmet-maker",,M,1,0,1,1,0,1,68
1354,"Orm of Ashkirk, son of Acwulf",,M,1,0,1,1,0,1,68
1421,Church of Lanark,,I,1,0,1,1,0,1,68
1061,Hospital of St Nicholas (in St Andrews),,I,3,0,3,5,0,5,68
691,"St Andrews Priory, Northampton",,I,6,0,6,6,0,6,9
847,William de Montfort,,M,1,0,1,1,0,1,68
1007,Restenneth Priory,,I,1,0,1,1,0,1,68
959,Brotherhood (Fraternity) of Glasgow,,I,1,0,1,1,0,1,68
1022,"Odo of Kinninmonth, steward, marischal (d.c.1195)",,M,4,0,4,5,0,5,73
1010,"Agatha, wife of Humphrey Barclay",,F,1,0,1,1,0,1,68
474,"Guy, abbot of Lindores (d.1219)",,M,2,0,2,2,0,2,77
2498,William of Tottenhall,,M,2,0,2,2,0,2,68
1026,Hugh of Benholm,,M,2,0,2,2,0,2,69
962,"Robert III, abbot of Scone (1186-98)",,M,1,0,1,1,0,1,68
822,"William, prior of May (fl.1166x71)",,M,1,0,1,2,0,2,68
890,Church of St Mary's Isle (KCB),,I,1,0,1,1,0,1,68
879,"Robert, son of Henry, butler (FIF)",,M,1,0,1,1,0,1,68
838,Elgin Cathedral,,I,8,0,8,15,0,15,69
897,MacDuff (1230s),,M,1,0,1,1,0,1,68
927,"Jordan, son of William, son of Nigel",,M,1,0,1,1,0,1,68
919,"Nar, man of abbot of Scone",,M,1,0,1,1,0,1,68
630,"Church of St John, Roxburgh",,I,3,0,3,3,0,3,73
898,Ralph Frebern,,M,2,0,2,2,0,2,68
921,"James, son of Lambin of Loudoun",,M,3,0,3,3,0,3,71
1167,"Hugh, son of Hugh of Benholm",,M,1,0,1,1,0,1,68
1160,Unknown deacon and subdeacon of Glasgow Cathedral,,M,2,0,2,2,0,2,71
1151,"Robert, son of Machus son of Undweyn",,M,1,0,1,1,0,1,68
1158,"Humphrey the young, son of Theobald de Addeville",,M,1,0,1,1,0,1,68
1210,Sons of Edward of Oldcambus,,M,1,0,1,1,0,1,68
734,Guisborough Priory,,I,6,0,6,7,0,7,67
1211,Grieves of Inverkeithing,,M,2,0,2,2,0,2,71
1100,"Alexander Seton, son of Philip of Seton",,M,1,0,1,1,0,1,68
1067,"William, son of Alexander",,M,2,0,2,2,0,2,68
14651,"Gregory Melville (I), son of Geoffrey (I)",,M,1,0,1,2,0,2,68
1096,"Geoffrey Blund, burgess of Inverness",,M,1,0,1,1,0,1,68
1081,"Henry, son of Gregory the clerk",,M,1,0,1,1,0,1,68
1120,Manuel Priory,,I,3,0,3,5,0,5,71
832,William de Valognes (d.1219),,M,1,0,1,1,0,1,68
1116,"Walter Scott, the younger",,M,1,0,1,1,0,1,68
1114,"William, son of Robert, son of Henry the butler (FIF)",,M,1,0,1,1,0,1,68
582,Saint Cuthbert,,M,50,0,50,75,0,75,3
2488,"Michael, clerk of Bishop Matthew of Aberdeen",,M,1,0,1,2,0,2,73
2541,"Hospital of St Peter, Aberdeen",,I,1,0,1,1,0,1,73
10751,Church of St Mo-ChonÄŹĹĽËťc of Inverkeilor,,I,1,0,1,1,0,1,68
15804,"William, son of Richard",,M,1,0,1,1,0,1,68
8411,"Richard of Balwearie, knight",,M,2,0,2,2,0,2,73
4929,"Adam of Blair, knight (mid13C)",,M,1,0,1,1,0,1,73
9250,Pain of Hedley (12C),,M,1,0,1,1,0,1,68
13964,"Roger de Argenten, master",,M,1,0,1,1,0,1,68
15770,"Sybil, wife of Robert de Stuteville, daughter of Philip de Valognes",,F,1,0,1,1,0,1,74
15769,Robert de Stuteville (early 13C),,M,1,0,1,1,0,1,74
210,Deer Abbey (Cist.),,I,3,0,3,4,0,4,73
5584,Robert of the Wardrobe,,M,1,0,1,1,0,1,73
6257,"Cospatric, son of Matad(in)",,M,1,0,1,1,0,1,73
5821,"John, son of Geoffrey",,M,1,0,1,1,0,1,73
3279,"Merleswain of Ardross, lord of Innergellie",,M,2,0,2,2,0,2,73
3449,"Christian de l'Isle, sheriff of Perth",,M,8,0,8,8,0,8,67
14565,"Thomas, clerk, nepos of William Maule (12C)",,M,2,0,2,2,0,2,72
2822,Church of Rattray,,I,2,0,2,2,0,2,74
3002,"William, son of Lambin",,M,2,0,2,2,0,2,71
4105,Church of Linlithgow,,I,2,0,2,3,0,3,66
703,"Church of St Mary, Haddington",,I,2,0,2,3,0,3,73
4047,Monymusk Priory,,I,12,0,12,16,0,16,68
3897,"Church of St Andrew, Gullane",,I,4,0,4,6,0,6,69
208,Hospital of Soutra,,I,33,0,33,43,0,43,70
3546,"Richard de Thouny, clerk of Bishop Malveisin",,M,1,0,1,1,0,1,68
1957,Balmerino Abbey (fd.1229),,I,21,0,21,35,0,35,71
4011,Church of Kettins,,I,1,0,1,1,0,1,68
3999,"Unknown, vicar of Innerwick",,M,1,0,1,1,0,1,68
4000,"Unknown, vicar of Legerwood",,M,1,0,1,1,0,1,68
15672,"Reginald, chaplain (WLO)",,M,1,0,1,1,0,1,68
5048,Hospital of St Mary of Loch Leven,,I,2,0,2,3,0,3,69
15688,"Priory of Christ Church, Canterbury ",,I,2,0,2,2,0,2,92
2409,Hospital of St Edward of Berwick,,I,2,0,2,2,0,2,69
4671,Church of Roxburgh Castle,,I,1,0,1,1,0,1,71
1038,Bishops of Moray,,M,3,0,3,6,0,6,71
4663,Chapel of St Nicholas of Boharm,,I,1,0,1,1,0,1,71
4662,"Adam, son of Constantine of Lochore",,M,1,0,1,1,0,1,71
4645,Ivo of Kirkpatrick,,M,2,0,2,2,0,2,71
4653,Gillanders MacLeod,,M,1,0,1,2,0,2,71
4644,"Absalom, son of Macbeth (Buchanan)",,M,2,0,2,2,0,2,66
122,Hospital of St John of Jerusalem,,I,3,0,3,3,0,3,73
4690,"Malcolm, thane of Callendar (mid 13C)",,M,3,0,3,6,0,6,71
60,"Patrick, son of William, son of Orm (Abernethy) (fl.1230s-40s)",,M,1,0,1,2,0,2,71
4679,"Walter, messenger of Queen Ermengarde",,M,1,0,1,1,0,1,71
61,Sixhills Priory (Lincs),,I,3,0,3,5,0,5,71
4328,Beauly Priory,,I,7,0,7,10,0,10,69
4613,"Unknown, keeper of bridge of Spey",,M,1,0,1,1,0,1,71
476,"Harald, bishop of Argyll (d.1228x32)",,M,1,0,1,1,0,1,71
4628,Dalmilling Priory,,I,2,0,2,5,0,5,71
4635,Chapel of St Catherine Orbiston,,I,1,0,1,1,0,1,71
4506,Saint Abbe,,F,22,0,22,29,0,29,3
4633,Saint Edward,,M,1,0,1,2,0,2,71
4478,Burgesses of Dumbarton,,M,1,0,1,6,0,6,71
4599,"Congal, son of Duncan, son of Malise",,M,1,0,1,1,0,1,71
22707,"Hugh Fleming, son of Simon son of Bertolf",,M,2,0,2,2,0,2,66
4707,Richard Murray (1230s),,M,1,0,1,1,0,1,71
2222,Order of the Temple of Solomon of Jerusalem,,I,2,0,2,3,0,3,71
4123,Pluscarden Priory,,I,2,0,2,13,0,13,71
2402,Burgesses of Lanark,,M,2,0,2,2,0,2,67
5030,"Margaret of Leny, daughter of Gillespie of Leny",,F,1,0,1,1,0,1,71
5029,Alan of Leny,,M,1,0,1,1,0,1,71
4736,"Gillespie, son of Gilchrist",,M,1,0,1,1,0,1,71
4708,Hospital of Elgin,,I,1,0,1,1,0,1,71
722,Saint John the Evangelist,,M,5,0,5,7,0,7,69
4547,Culross Abbey,,I,4,0,4,7,0,7,71
247,Saint Andrew,,M,10,0,10,15,0,15,73
3460,Sacristy of Scone Abbey,,I,2,0,2,2,0,2,71
3997,"Richard Murray, brother of Gilbert, bishop of Caithness",,M,1,0,1,2,0,2,71
4720,Unknown neyfs and servi of bishops of Glasgow,,M,1,0,1,1,0,1,71
1179,Bishops of Glasgow,,M,3,0,3,4,0,4,1
4440,Anselm of Camelon,,M,1,0,1,1,0,1,71
3805,"Robert de Wauchope, knight",,M,1,0,1,1,0,1,71
4423,Joan Chamberlain (Chalmers),,F,1,0,1,1,0,1,71
4494,Ralph de Hauville,,M,1,0,1,1,0,1,71
1855,"Joan, queen of Scots (d.1238)",,F,1,0,1,1,0,1,71
4394,"Geoffrey of Farsley, knight",,M,1,0,1,2,0,2,71
4422,Richard Chamberlain (Chalmers),,M,1,0,1,1,0,1,71
2082,"Roger, abbot of Newbattle (d.1256)",,M,1,0,1,1,0,1,71
4386,Bishopric of Argyll,,I,1,0,1,1,0,1,71
4382,"Roger (III) Bigod, earl of Norfolk (d.1270)",,M,1,0,1,1,0,1,71
55,"Richard Revel, lord of Coultra (d.1215x25)",,M,1,0,1,2,0,2,71
4417,Bernard of Cargill,,M,1,0,1,1,0,1,71
1974,Archibald Douglas,,M,2,0,2,2,0,2,73
4409,"Norrin, son of Norman",,M,1,0,1,1,0,1,71
4407,Burgh of Dumbarton,,M,1,0,1,1,0,1,71
2113,Matthew of Moncreiffe,,M,6,0,6,7,0,7,74
1891,"Thomas, son of William, knight (13C)",,M,1,0,1,1,0,1,71
4553,Gregory of Cambusmichael,,M,1,0,1,1,0,1,71
4572,"Rory (Roderic), son of Gilchrist",,M,1,0,1,1,0,1,71
1011,"Walter, son of John, son of Berewald Fleming",,M,1,0,1,1,0,1,71
4554,"Robert, abbot of Scone (IV or V)",,M,1,0,1,1,0,1,71
4544,"Robert, heir of John, son of Theobald",,M,1,0,1,1,0,1,71
2352,Friars Preachers of Perth,,I,1,0,1,1,0,1,71
4604,Burgesses of Dingwall,,M,1,0,1,1,0,1,71
4602,Friars Preachers of Edinburgh,,I,1,0,1,1,0,1,71
4257,Saint Nicholas,,M,6,0,6,6,0,6,69
4597,Burgesses of Stirling,,M,1,0,1,2,0,2,71
4591,"Simon Fleming, son of Simon, son of Bertolf",,M,1,0,1,1,0,1,71
4590,"Cairell, son of Malcolm, judex (ANG/ KCD)",,M,1,0,1,1,0,1,71
4588,"Hugh Crawford, knight (1220s)",,M,2,0,2,4,0,4,71
4543,"John, son of Theobald",,M,1,0,1,1,0,1,71
4490,"Geoffrey, porter of Melrose Abbey",,M,1,0,1,1,0,1,71
4523,"Richard, prior of Coldingham (d.c.1248)",,M,9,0,9,9,0,9,3
4528,Richard Murray (in Clydesdale),,M,1,0,1,1,0,1,71
4510,Jordan of Corra,,M,1,0,1,1,0,1,71
4517,"Ivo, cook, son of Nigel the cook (king's cook)",,M,1,0,1,2,0,2,71
7861,"Archibald, son of Michael Fleming",,M,1,0,1,1,0,1,71
3376,Saint Serf,,M,4,0,4,4,0,4,66
4018,"Unknown, vicar of Dundee",,M,1,0,1,1,0,1,68
15270,"John, chaplain of Inchmartine",,M,1,0,1,1,0,1,74
10451,"John Kinman, steward, son of Rugeram",,M,2,0,2,2,0,2,67
91,"Geoffrey, abbot of Dunfermline (d.1178)",,M,1,0,1,1,0,1,73
316,"Church of St John the Baptist, Perth",,I,1,0,1,1,0,1,73
333,Berewald Fleming,,M,1,0,1,1,0,1,73
347,celi De of St Andrews,,I,1,0,1,1,0,1,73
106,"Alured, abbot of Cambuskenneth (fl.1152x53-1172x78)",,M,1,0,1,1,0,1,73
711,Wardon Abbey,,I,2,0,2,2,0,2,66
697,Whitby Abbey (St Hilda),,I,6,0,6,7,0,7,9
392,Monks of Rhynd,,M,1,0,1,1,0,1,73
213,"Baldwin, lorimer of Perth",,M,2,0,2,2,0,2,73
375,Burgesses of St Andrews,,M,3,0,3,4,0,4,73
1713,Tiron Abbey,,I,3,0,3,4,0,4,73
88,"William, abbot of Holyrood (I) (d.1172)",,M,1,0,1,2,0,2,73
288,"Richard of Stirling, chaplain (TRM)",,M,1,0,1,1,0,1,73
234,"Robert II, abbot of Scone (d.1186)",,M,2,0,2,8,0,8,73
107,"Osbert, abbot of Jedburgh (d.1174)",,M,1,0,1,1,0,1,73
279,"Unknown, prior of Paisley",,M,1,0,1,1,0,1,73
1717,"Philip of Lundin, the chamberlain",,M,1,0,1,1,0,1,73
253,"Robert, prior of St Andrews (d.1160)",,M,4,0,4,7,0,7,73
22722,Harrold Priory,,M,1,0,1,1,0,1,73
3586,Church of Clockston,,I,1,0,1,1,0,1,71
12954,Unknown infirm of Richard de Moreville at 'Bune',,M,1,0,1,1,0,1,71
5377,Patrick Scott (brother of John Scott of Reston),,M,1,0,1,1,0,1,3
12949,"Aelsi, son of Winter, sheriff (father of Alan)",,M,1,0,1,1,0,1,9
4782,Lambin Asa,,M,1,0,1,1,0,1,73
3009,"Church of St Cuthbert, Ednam",,I,1,0,1,1,0,1,73
4788,Theobald Fleming,,M,1,0,1,1,0,1,73
4822,"Waltheof, son of Bodin",,M,1,0,1,2,0,2,69
4824,Gilla Mo Fhecu,,M,1,0,1,1,0,1,69
811,"Reginald, abbot of Arbroath  (d.1179)",,M,1,0,1,1,0,1,69
4846,"Laurence, son of Edmund of Edinburgh",,M,1,0,1,1,0,1,69
4844,"Osbern, man of Kelso Abbey",,M,1,0,1,1,0,1,69
4130,Arrouaise Abbey,,I,1,0,1,1,0,1,73
132,Beatrice de Beauchamp,,F,1,0,1,1,0,1,73
528,Eustace fitz John (d.1157),,M,1,0,1,2,0,2,73
1751,"William, son of Aelfric",,M,1,0,1,1,0,1,73
1753,Tynemouth Priory,,I,1,0,1,1,0,1,73
1754,Saint Oswin,,M,1,0,1,1,0,1,73
652,Arnulf of Morwick/Swinton,,M,2,0,2,3,0,3,73
1457,Furness Abbey,,I,10,0,10,13,0,13,9
14433,Hospital of Lauder,,I,1,0,1,1,0,1,71
15077,"Eadwulf, son of Uhtred",,M,2,0,2,2,0,2,71
6820,Saint Leonard,,M,5,0,5,5,0,5,71
6498,Henry Sinclair (early 13C),,M,1,0,1,2,0,2,71
15536,"St James Abbey, Northampton",,I,1,0,1,1,0,1,71
2254,Coldstream Priory,,I,37,0,37,65,0,65,72
3787,"Richard, chaplain of Alan of Galloway",,M,2,0,2,2,0,2,9
701,"Church of St Cuthbert, Edinburgh",,I,1,0,1,1,0,1,73
1673,Selkirk Abbey,,I,1,0,1,1,0,1,73
133,"Nicholas of Roxburgh, chancellor (d.1171?)",,M,1,0,1,2,0,2,73
457,"Geoffrey, abbot of Dunfermline (d.1154)",,M,1,0,1,3,0,3,73
549,Urquhart Priory,,I,1,0,1,2,0,2,73
437,Robert Bruce I (d.1142),,M,1,0,1,1,0,1,73
151,Walter Ryedale (d.1156),,M,1,0,1,1,0,1,73
4256,"Hospital of St Nicholas, Boat o'Brig",,I,6,0,6,7,0,7,69
875,"Hervey, marischal (Keith)",,M,1,0,1,1,0,1,73
3165,Church of Dunbar,,I,1,0,1,1,0,1,73
13026,Hospital of Kelso,,I,1,0,1,1,0,1,9
2686,Churches of Roxburgh,,I,1,0,1,1,0,1,72
926,"Elias of Partick, clerk, canon (son of Fulbert)",,M,1,0,1,1,0,1,72
1853,Henry Boyle (de Boiville),,M,1,0,1,1,0,1,67
1887,David de Audri,,M,1,0,1,1,0,1,67
1794,Simon of Billingham,,M,1,0,1,1,0,1,67
1788,Robert of Billingham,,M,1,0,1,1,0,1,67
1796,"Malcolm (of Leslie), son of Bertolf (d.c.1200)",,M,1,0,1,1,0,1,67
1808,Robert Furmage,,M,1,0,1,1,0,1,67
7944,Church of Dunipace,,I,1,0,1,1,0,1,72
2921,"Church of St Laurence, Berwick",,I,1,0,1,1,0,1,73
739,Walter of Stirling,,M,1,0,1,1,0,1,73
2945,"Mainard Fleming, grieve of St Andrews",,M,1,0,1,2,0,2,73
1912,Inchcolm Abbey,,I,19,0,19,20,0,20,73
7964,"Hugh, son of Ingebald ",,M,1,0,1,1,0,1,75
1723,"Everard, abbot of Holm Cultram (d.1192)",,M,2,0,2,2,0,2,75
1434,Ivo of Crosbie,,M,1,0,1,1,0,1,75
1599,Saint Michael,,M,4,0,4,4,0,4,69
8492,celi De of Monymusk,,M,1,0,1,1,0,1,68
146,Saint Columba,,M,3,0,3,4,0,4,74
8742,"William of Mercheley, monk of Merchingley",,M,2,0,2,3,0,3,69
9412,Adam of Edington,,M,2,0,2,2,0,2,0
12080,"Oddger of Tyas ",,M,2,0,2,2,0,2,73
12524,"William, nepos of Arnold the prior ",,M,2,0,2,2,0,2,73
7899,"Ralph, son of Godwin",,M,2,0,2,4,0,4,73
12581,"William of Mitford, vicar of Oldcambus",,M,2,0,2,2,0,2,0
13872,Church of St Giles of Binny,,I,1,0,1,1,0,1,9
6839,"Richard, son of Truite",,M,1,0,1,1,0,1,68
1611,Residents of Island(shire) and Norham,,M/F,1,0,1,1,0,1,3
1614,Men of Coldingham,,M,1,0,1,1,0,1,3
849,"Alan, son of Simon, son of Michael (Kinninmonth)",,M,1,0,1,1,0,1,68
1602,Saint John,,M,7,0,7,8,0,8,69
15427,Church of Bara,,I,1,0,1,1,0,1,73
1949,Roger Frebern,,M,1,0,1,1,0,1,68
6503,Alan of Clapham,,M,3,0,3,6,0,6,71
4557,"William of Hartside, sheriff of Lanark",,M,1,0,1,1,0,1,71
1647,St Bees Priory,,I,10,0,10,10,0,10,75
1648,Saint Bee,,F,3,0,3,3,0,3,75
13592,Church of Lessudden,,I,2,0,2,2,0,2,9
8558,"Patrick, chaplain of Dunbar",,M,1,0,1,1,0,1,73
2388,"William of Swinburne, treasurer, baillie",,M,2,0,2,3,0,3,67
2001,"Patrick Graham, knight (d.1296)",,M,9,0,9,12,0,12,66
2369,"John of Swinburne, knight (d.c.1313)",,M,1,0,1,2,0,2,67
2358,"Walter Edgar, son of Patrick Edgar",,M,2,0,2,3,0,3,1
2338,"Roland of Carrick, knight",,M,2,0,2,2,0,2,66
2343,Burgesses of Kinghorn,,M,1,0,1,1,0,1,67
2335,"William of Badby, constable of Berwick",,M,2,0,2,2,0,2,67
2300,Houston Hospital,,I,1,0,1,1,0,1,67
2288,Burgesses of Elgin,,M,1,0,1,1,0,1,67
2345,Friars Preachers of Inverness,,I,1,0,1,1,0,1,67
4487,"Unknown, mayor of Berwick",,M,1,0,1,1,0,1,67
1282,Grieves of Berwick,,M,1,0,1,1,0,1,67
4488,Burgh of Berwick,,I,1,0,1,1,0,1,67
2305,"Guy, count of Flanders (d.1305)",,M,1,0,1,1,0,1,67
2109,"Alexander de Montfort, sheriff of Elgin",,M,1,0,1,1,0,1,67
2062,John of Pitcairn,,M,1,0,1,1,0,1,67
2086,"Eve, sister of Mael Domnaig, earl of Lennox",,F,2,0,2,3,0,3,66
2206,William Douglas of Lothian (son of Andrew Douglas),,M,1,0,1,1,0,1,67
2185,"John Sparetunt, burgess of Perth",,M,1,0,1,1,0,1,67
2178,Lindisfarne Priory,,I,2,0,2,2,0,2,73
2177,"Henry, prior of Lindisfarne",,M,1,0,1,1,0,1,67
2262,"Margery, wife of Gilbert of Glencarnie (II)",,F,1,0,1,1,0,1,67
1955,William Sinclair (d.1299x1303),,M,2,0,2,4,0,4,67
1664,Saint Ninian,,M,6,0,6,6,0,6,9
2226,Malcolm of Lamberton,,M,1,0,1,1,0,1,67
2261,"Gilbert or Gilla Brigte of Glencarnie (II), son of Gilbert (I)",,M,1,0,1,2,0,2,67
1338,Men of Dunfermline Abbey,,M,1,0,1,1,0,1,67
6374,"William of Dallas, knight",,M,1,0,1,1,0,1,67
11465,William Hay (III) (son of David),,M,1,0,1,1,0,1,67
2169,"Richard of Straiton, knight",,M,1,0,1,1,0,1,67
7566,Hospitallers (general),,I,2,0,2,2,0,2,69
22746,"Malcolm, son of Malcolm, son of Serlo of Edinburgh",,M,1,0,1,1,0,1,66
13305,Saint Benedict,,M,3,0,3,3,0,3,69
16019,"Robert Crook, knight (12C)",,M,1,0,1,1,0,1,66
3214,Saint James,,M,3,0,3,3,0,3,66
3215,Saint Mirin,,M,2,0,2,2,0,2,66
4878,"William, son of Ingram (son of Edmund, son of Forni)",,M,1,0,1,3,0,3,73
4153,Church of St Ninians (Kirkton),,I,1,0,1,1,0,1,72
3781,Parishioners of Clova,,M/F,1,0,1,1,0,1,72
4181,"Brice, chaplain, vicar of East Calder",,M,1,0,1,1,0,1,72
3774,"Gilbert of Kent, clerk of Bishop David",,M,1,0,1,1,0,1,72
4169,"John, son of John of the Cellar",,M,1,0,1,2,0,2,72
3779,"Unknown, chaplain of Clova",,M,1,0,1,1,0,1,72
15667,Scotlandwell Hospital,,I,2,0,2,3,0,3,72
5988,Dunbar Trinitarian Friary,,I,2,0,2,2,0,2,72
4162,Canons of Glasgow,,M,1,0,1,2,0,2,71
2334,"William of Cadzow, canon of Glasgow",,M,1,0,1,1,0,1,66
5845,Church of St Nicholas of Hume,,I,1,0,1,1,0,1,3
5968,Thomas Papedy,,M,1,0,1,1,0,1,3
6188,"Henry, prior of Coldingham (Sylton or Horncaster?)",,M,1,0,1,1,0,1,72
6010,"Margaret, wife of Geoffrey of Caldcoats",,F,1,0,1,1,0,1,72
6009,Geoffrey of Caldcoats,,M,1,0,1,1,0,1,72
3922,Alexander of Huntingdon,,M,1,0,1,1,0,1,71
6434,"Alan de Ros ",,M,1,0,1,1,0,1,71
3408,Church of St Cuthbert of Channelkirk,,I,5,0,5,6,0,6,9
4027,"Alan Sinclair, knight",,M,1,0,1,1,0,1,75
6682,"Matilda of Windsor, wife of Alan Sinclair",,F,1,0,1,1,0,1,75
3549,"Nicholas of Milton, clerk (fl.1264)",,M,3,0,3,3,0,3,9
3441,"Patrick Dunn, clerk, vicar of Dalmeny",,M,1,0,1,1,0,1,73
3375,Loch Leven Priory,,I,2,0,2,3,0,3,9
2670,Lanercost Priory,,I,5,0,5,5,0,5,77
5137,Dunblane Cathedral,,I,6,0,6,6,0,6,67
6928,"Gilla Tomais, son of Malise the steward",,M,1,0,1,1,0,1,69
5170,"Robert, son of Hugh, son of Spileman",,M,1,0,1,1,0,1,76
3842,"John, prior of Inchaffray (fl.1212x14)",,M,1,0,1,1,0,1,68
7255,"J. [Isaac?], hermit at Inchaffray",,M,1,0,1,1,0,1,68
4847,"Constantine, son of Gilbert",,M,1,0,1,1,0,1,77
4851,"Ralph, serviens of Lesmahagow",,M,1,0,1,1,0,1,77
5248,Brinkburn Priory,,I,5,0,5,5,0,5,77
4853,"David, son of Peter dean of Stobo",,M,2,0,2,2,0,2,77
4070,Church of Bourtie,,I,2,0,2,2,0,2,71
2859,Church of St Michael of Maxwell,,I,1,0,1,1,0,1,68
3904,"Peter Bovenell, clerk",,M,1,0,1,1,0,1,73
5421,"Stephen Bovenell, clerk",,M,1,0,1,1,0,1,73
12540,Humphrey of Raperlaw,,M,1,0,1,1,0,1,73
8251,"Adam of Carlisle, son of Robert",,M,1,0,1,1,0,1,71
6255,"John, son of Uhtred",,M,1,0,1,1,0,1,68
4173,"Hugh Murray, lord of Duffus",,M,1,0,1,1,0,1,68
5410,"Walter of Earlston, clerk",,M,2,0,2,2,0,2,97
4855,"A., son of James",,M,1,0,1,1,0,1,66
4848,"Gilbert, son of Saludes",,M,1,0,1,1,0,1,66
4857,"Richard, son of Solph",,M,1,0,1,1,0,1,66
2869,"Church of St Peter, Duffus",,I,1,0,1,1,0,1,68
2868,"Andrew, persona of Duffus, clerk",,M,1,0,1,1,0,1,68
2598,"Andrew, priest/persona (Brechin)",,M,1,0,1,2,0,2,68
2876,"Patrick, son of William, persona of Abernethy",,M,1,0,1,2,0,2,68
6105,Bishopric of Moray,,I,1,0,1,1,0,1,73
1025,Aberdeen Cathedral,,I,4,0,4,4,0,4,86
4238,"William Murray, canon of Moray (fl.1223x30)",,M,1,0,1,1,0,1,69
4278,"Simon, canon of Moy",,M,1,0,1,1,0,1,69
3871,"Edward Murray, master, canon, bishop's clerk",,M,1,0,1,1,0,1,69
4272,"Hugh of Duffus, canon of Moray and Spynie, master",,M,1,0,1,1,0,1,69
3687,"Robert of Duffus, canon of Dipple and Moray",,M,1,0,1,1,0,1,69
3416,Thomas of Croy,,M,1,0,1,1,0,1,69
4175,"Lambert, succentor of Moray",,M,1,0,1,1,0,1,69
4273,"Duncan, son of Gilla Micheil mac Ath",,M,1,0,1,1,0,1,69
4319,"Henry, master, vicar of Duffus (fl.1238)",,M,1,0,1,1,0,1,69
4236,"Unknown, subdean of Moray (Adam or William)",,M,1,0,1,1,0,1,69
4216,Chapter of Elgin,,I,1,0,1,1,0,1,69
4233,"Unknown, dean of Moray (1223x30)",,M,1,0,1,1,0,1,69
4234,"Unknown, chancellor of Moray (1223x30)",,M,1,0,1,1,0,1,69
3869,"Henry, master, treasurer, chancellor of Moray",,M,1,0,1,1,0,1,69
4235,"Unknown, archdeacon of Moray (1223x30)",,M,1,0,1,1,0,1,69
4349,"William of Ross, clerk of Bishop Gilbert of Caithness",,M,1,0,1,1,0,1,78
4345,Chapter of Caithness,,I,1,0,1,1,0,1,78
4350,"Eudo, chaplain of Bishop Gilbert of Caithness",,M,1,0,1,1,0,1,78
3632,"William, son of Nicholas, canon-sacrist of Holyrood",,M,1,0,1,1,0,1,79
4918,"William, son of William, goldsmith of Perth",,M,1,0,1,1,0,1,80
4917,"John Haylbotyl, burgess of Perth (early 13C)",,M,1,0,1,1,0,1,80
6603,"Loretta, daughter of Saer de Quincy",,F,1,0,1,1,0,1,68
2620,Monks of Arbroath,,M,2,0,2,5,0,5,68
5224,Richard White of Dundee,,M,1,0,1,1,0,1,81
15678,"Adam, chaplain of Bishop Robert of Ross",,M,1,0,1,1,0,1,69
972,"William, son of Adam of Nevay",,M,1,0,1,1,0,1,73
3101,"Church of St Kentigern, Borthwick",,I,1,0,1,1,0,1,73
3085,"Geoffrey of Perth, clerk of Bishop Roger",,M,1,0,1,1,0,1,73
3087,Church of Errol,,I,2,0,2,3,0,3,73
3108,"Alan of Richmond, master (fl.1189-1214x33)",,M,1,0,1,1,0,1,73
5079,Hospital of Crookston (?),,I,1,0,1,1,0,1,66
5067,Henry of Ness,,M,1,0,1,1,0,1,66
2828,Church of Cargill,,I,1,0,1,1,0,1,74
2697,"Gilbert, son-in-law of Uhtred",,M,3,0,3,3,0,3,74
1841,"Hugh of Potton, archdeacon of Glasgow (d.1238)",,M,1,0,1,1,0,1,66
5302,"Aldan, son of Duna",,M,1,0,1,1,0,1,82
7433,Church of St Nicholas of the Island of Elbottle,,I,3,0,3,5,0,5,69
3619,Osmund of Gullane,,M,1,0,1,1,0,1,69
15102,"Chapel of St Laurence of Kinblethmont ",,I,1,0,1,1,0,1,68
1539,Matilda Malherbe,,F,1,0,1,1,0,1,68
9265,Vaudey Abbey,,I,2,0,2,3,0,3,1
6090,Men of Earl Duncan of Fife,,M,1,0,1,1,0,1,73
10030,"Simon, chaplain of Mow",,M,1,0,1,1,0,1,72
8964,Church of St Cuthbert of East Calder,,I,1,0,1,1,0,1,72
14559,"Chapel of St Leonard, Tartraven",,I,1,0,1,1,0,1,73
14342,"Hugh, son of William (PER)",,M,2,0,2,2,0,2,73
1202,William Lunnok,,M,2,0,2,2,0,2,72
6343,"Gilbert or Gilla Brigte, nepos of Edgar son of Donald",,M,1,0,1,1,0,1,72
1915,Elias of Dundas (son of Uhtred),,M,1,0,1,1,0,1,73
15441,Bromholm Priory,,I,2,0,2,4,0,4,66
12791,Hospital of Addeston,,I,1,0,1,1,0,1,71
15402,"Robert, son of Uhtred of Pitroddie",,M,1,0,1,1,0,1,71
7441,"Ralph, prior of Coldingham (fl.1218x34)",,M,1,0,1,1,0,1,3
7994,Almshouse of Coldingham,,I,8,0,8,9,0,9,3
11849,Sacristy of Coldingham Priory,,I,3,0,3,3,0,3,3
424,"Arnold, prior of Coldingham (fl.c.1195x1207-08x11)",,M,1,0,1,1,0,1,3
13319,Adam of Quixwood,,M,1,0,1,1,0,1,3
482,"Herbert, prior of Coldingham (fl.1172x74-75)",,M,1,0,1,1,0,1,3
13687,"Robert, son of Matilda",,M,1,0,1,1,0,1,3
4672,Hospital of Jerusalem of Torphichen,,I,2,0,2,2,0,2,71
9647,Henry Graham (TRA3),,M,1,0,1,1,0,1,66
11989,William of Preston (son of John),,M,3,0,3,3,0,3,66
15511,"Stephen, son of Nicholas, burgess of Renfrew",,M,1,0,1,1,0,1,66
22334,"Unknown, abbot of Holyrood (13C)",,M,1,0,1,1,0,1,66
1488,"St Mary's Abbey, Dublin",,I,1,0,1,1,0,1,9
1665,"Richard, bishop of the Isles (d.1275)",,M,1,0,1,2,0,2,75
1537,"St Werburg Abbey, Chester",,I,1,0,1,1,0,1,83
1571,"William, bishop of Durham (d.1096)",,M,1,0,1,1,0,1,3
5081,Unknown procurators of Dryburgh Abbey,,M,1,0,1,1,0,1,9
7882,"Roger of Mercheley, monk of Merchingley",,M,2,0,2,3,0,3,69
14376,"Matilda, sister of John of Wilton",,F,1,0,1,1,0,1,66
8248,"Roger Crispin ",,M,1,0,1,1,0,1,67
8045,Robert of Crosbie,,M,1,0,1,1,0,1,67
8179,"Humphrey, son of Simon",,M,1,0,1,1,0,1,67
13076,"Helen, daughter of Simon Lindsay",,F,3,0,3,3,0,3,72
5049,"Ralph, chaplain of Crail",,M,1,0,1,1,0,1,84
8198,Clairvaux Abbey,,I,1,0,1,1,0,1,67
2381,"David of Torthorwald, knight (d.c.1296)",,M,2,0,2,2,0,2,67
8234,"Henry of Kirkcudbright ",,M,1,0,1,1,0,1,67
8242,William de Heineville,,M,1,0,1,1,0,1,67
7522,Sweetheart Abbey,,I,1,0,1,1,0,1,9
12027,Hospital of Kincardine O'Neil,,I,1,0,1,3,0,3,74
12223,Chapel of Logie Durno,,I,1,0,1,1,0,1,74
2280,"Gilbert or Gilla Brigte, son of Earl Gilbert, lord of Glencarnie (I) (d.a.1267)",,M,1,0,1,1,0,1,74
12177,"Unknown, grandson of Alan Durward",,M,1,0,1,1,0,1,74
5260,"Thomas Bonar, burgess of Aberdeen",,M,1,0,1,2,0,2,85
6268,Prebendaries at Newburgh in Buchan,,M,1,0,1,1,0,1,68
6296,"Fergus, son of John of Fiddes ",,M,1,0,1,1,0,1,68
1356,Jordan Comyn,,M,1,0,1,1,0,1,68
6265,Turriff Almshouse (Hospital),,M,1,0,1,1,0,1,68
3188,Adam son of Robert of Pilmore (late 13C),,M,1,0,1,1,0,1,68
3187,William of Tottenhall (fl.1277),,M,3,0,3,3,0,3,86
4942,"John, armiger (armour-bearer)",,M,1,0,1,1,0,1,87
4943,"Peter, son of Adam",,M,1,0,1,1,0,1,87
4944,"Thomas, son of Bernard",,M,1,0,1,1,0,1,87
4945,Richard of Kirkland,,M,1,0,1,1,0,1,87
4946,Magot de Craggy,,F,1,0,1,1,0,1,87
4947,"John, flocker",,M,1,0,1,1,0,1,87
4948,"Eve, daughter of John Harloth",,F,1,0,1,1,0,1,87
4949,"Susanna, wife of John, armiger",,F,1,0,1,1,0,1,87
4953,"Malcolm, son of Malcolm of Frendraught",,M,1,0,1,1,0,1,87
5028,"Peter de Campania (Champagne), clerk",,M,1,0,1,1,0,1,9
2557,"Oliver, abbot of Dryburgh (fl.1262-73x)",,M,1,0,1,1,0,1,9
4925,"Emma, wife of Thomas del Bois",,F,1,0,1,1,0,1,71
3996,"Alan of Soutra, vicar of Peterculter",,M,2,0,2,2,0,2,71
3324,Precentory of Dunkeld,,I,1,0,1,1,0,1,73
2451,"Bishops from England, Ireland, Wales or Scotland",,M,1,0,1,1,0,1,88
7173,Church of Migvie,,I,1,0,1,1,0,1,67
7174,"Unknown, vicar of Migvie",,M,1,0,1,1,0,1,67
6661,Tenants of Holyrood Abbey in Preston (ELO),,M/F,1,0,1,1,0,1,9
5588,"Serlo / Saer Seton, knight",,M,1,0,1,1,0,1,9
3355,John of Kinloch,,M,3,0,3,4,0,4,9
7378,"Adam Seton, master, chaplain",,M,1,0,1,1,0,1,9
6702,"Nicholas of Clackmannan, king's brewer",,M,1,0,1,1,0,1,9
1171,"William Murray, son of Malcolm Murray, knight (TRA3)",,M,8,0,8,10,0,10,89
7033,Malise of Logie,,M,1,0,1,1,0,1,67
18203,"Adam, son of Christina of Lumbennie",,M,2,0,2,2,0,2,74
14480,"Luke, son of Osmund ",,M,1,0,1,1,0,1,69
7276,"Gilla Martain, son of Gillemichel",,M,1,0,1,1,0,1,66
6739,"Mael Domnaig, son of Gilla Muire",,M,1,0,1,1,0,1,66
6548,"Luke, son of Michael of Fintry, dean of Lennox",,M,1,0,1,1,0,1,66
7277,"Gillecondad, son of Gilla Micheil",,M,1,0,1,1,0,1,66
7273,"Gilla Micheil, son of Gilla Micheil",,M,1,0,1,1,0,1,66
6171,Humphrey of Kilpatrick,,M,1,0,1,1,0,1,66
2159,"Mauricius (Murdoch), son of Galbraith",,M,1,0,1,1,0,1,66
6099,"Mael Domnaig, dean of Lennox",,M,1,0,1,1,0,1,66
6875,Stephen of Blantyre,,M,1,0,1,2,0,2,66
7235,"Donald, son of Macynel",,M,1,0,1,1,0,1,66
7232,"William, son of Arthur son of Galbraith",,M,1,0,1,1,0,1,66
6910,"Gilla Muire, son of Maldoven",,M,1,0,1,2,0,2,66
7218,"Arthur, son of Murethach",,M,1,0,1,1,0,1,66
7217,"Maurice or Murdoch, son of Gillespie",,M,1,0,1,1,0,1,66
2938,William Douglas (d.x1274),,M,1,0,1,1,0,1,9
2107,Bernard Mowat (son of Michael),,M,1,0,1,1,0,1,90
14946,David of Denoon,,M,1,0,1,1,0,1,90
2331,"William de Gourlay, knight",,M,1,0,1,1,0,1,91
10490,"Maison Dieu, Brechin (Chapel of St Mary)",,I,1,0,1,2,0,2,74
11288,"Unknown, chaplain at Lindores Castle",,M,1,0,1,1,0,1,74
8377,Church of Abdie,,I,1,0,1,1,0,1,74
10984,Church of Rathmuriel (ChristÄŹĹĽËťs Kirk),,I,1,0,1,1,0,1,74
9756,Philip le Brun,,M,1,0,1,1,0,1,74
12886,"Margery, wife of Matthew of Moncreiffe",,F,1,0,1,1,0,1,74
3197,"Alexander of Allardice, (?) burgess of Aberdeen",,M,1,0,1,1,0,1,92
4799,"Duncan, judex (mid 13C)",,M,3,0,3,3,0,3,92
4798,Adam Wishart,,M,2,0,2,2,0,2,92
7374,"Duncan, son of Gilchrist",,M,1,0,1,1,0,1,66
7345,Michael mac Cessan,,M,1,0,1,1,0,1,66
7049,Arthur Galbraith,,M,1,0,1,2,0,2,66
7346,"Walter Sproull, steward of Malcolm earl of Lennox",,M,1,0,1,1,0,1,66
16015,"Malcolm, son of Gilla Micheil mac Eadwulf",,M,3,0,3,3,0,3,66
4941,"Thomas de Betheref, knight",,M,1,0,1,1,0,1,93
4926,"Richard, cook, serviens, burgess of Dunfermline",,M,1,0,1,2,0,2,93
4935,Duncan of Crambeth,,M,1,0,1,1,0,1,93
14722,Church of Mearns,,I,1,0,1,1,0,1,66
2127,"John Lindsay, knight",,M,1,0,1,1,0,1,66
11950,John Fraser (13C),,M,1,0,1,1,0,1,66
11103,House of Ardlogie (monks of Arbroath),,I,1,0,1,1,0,1,68
5271,Aberdeen Carmelite Friary,,I,3,0,3,4,0,4,69
7785,"John of Garioch, knight",,M,1,0,1,1,0,1,67
4071,"Robert de la Runce, vicar of Bourtie",,M,1,0,1,2,0,2,71
4761,"Malcolm, janitor of Edinburgh",,M,1,0,1,1,0,1,71
3809,Knights Templar of Maryculter,,I,1,0,1,1,0,1,71
3803,Churches of Aberdeen Cathedral,,I,1,0,1,1,0,1,71
4763,"Walter, son of Turpin",,M,1,0,1,1,0,1,71
5063,"Richard, son of Thomas",,M,1,0,1,1,0,1,71
3175,"Philip of Meldrum/Feodarg, knight",,M,3,0,3,3,0,3,74
9547,Alexander Ogilvie,,M,1,0,1,1,0,1,94
9590,Roger of Clunie,,M,1,0,1,1,0,1,74
7037,"Unknown, chaplain of Inchaffray Abbey",,M,2,0,2,3,0,3,69
7032,"Cecilia, daughter of Earl Malise of Strathearn",,F,1,0,1,1,0,1,67
7021,"Amabel, sister of Earl Malise of Strathearn",,M,1,0,1,1,0,1,67
405,"Alan, abbot of Inchaffray (fl.1258-71)",,M,1,0,1,1,0,1,67
7029,"Mary, daughter of Earl Robert of Strathearn",,F,1,0,1,1,0,1,67
14369,"John of Liddell, son of Thomas",,M,2,0,2,2,0,2,73
4801,"Andrew, son of Alexander",,M,1,0,1,1,0,1,92
5841,Peter of Ceres,,M,1,0,1,1,0,1,92
15347,Saint Ternan,,M,1,0,1,1,0,1,95
7177,Bishopric of Brechin,,I,1,0,1,1,0,1,95
6563,Saddell Abbey,,I,4,0,4,5,0,5,66
12039,"Richard Soylard ",,M,1,0,1,1,0,1,1
6921,"Alexander Menzies, knight",,M,1,0,1,1,0,1,96
5718,"John of Inchmartine, knight",,M,1,0,1,1,0,1,96
2509,"Henry of Horncastre, prior of Coldingham (fl.1276-96)",,M,2,0,2,2,0,2,3
2612,"William of Kent, master, clerk",,M,1,0,1,1,0,1,68
2043,"Nicholas of Meaux, bishop of the Isles (d.p.1226)",,M,1,0,1,1,0,1,9
3663,"Unknown, sacrist of Coldingham",,M,1,0,1,1,0,1,3
4412,"Rodbert, son of Gozo",,M,2,0,2,2,0,2,97
2563,"Paul, prior of Whithorn (fl.1217x35)",,M,1,0,1,1,0,1,9
3721,"Walter of Shelfanger, clerk",,M,2,0,2,2,0,2,98
5720,"Hugh of Lochore, sheriff of Fife",,M,2,0,2,2,0,2,73
4936,"Alexander of Blair (I), knight (early13C)",,M,2,0,2,2,0,2,99
13462,"Simon of Scrogges, son of Robert",,M,2,0,2,2,0,2,1
5683,"Church of St Modhrust (Drostan), Markinch",,I,1,0,1,1,0,1,99
5698,"Ness Ramsay, son of Ness Ramsay (mid13C)",,M,1,0,1,2,0,2,99
5691,"Richard, son of Andrew of Linton",,M,1,0,1,1,0,1,99
829,"Ranulf de Wat, archdeacon of St Andrews (d.1209)",,M,1,0,1,1,0,1,100
3575,"Henry of Rutherglen, monk of Paisley",,M,1,0,1,1,0,1,66
6998,"Gilbert or Gilla Brigte, son of Earl Robert of Strathearn",,M,2,0,2,2,0,2,69
1287,"Alan, son of Cospatric of Swinton",,M,1,0,1,1,0,1,69
15621,"John, son of William son of Lambin",,M,2,0,2,2,0,2,67
5873,"Amabel, mother of Richard of Fans",,F,2,0,2,2,0,2,72
14151,"Richard, son of Roger, burgess of Dundee",,M,1,0,1,1,0,1,67
5075,Berwick Priory (South Berwick),,I,2,0,2,2,0,2,9
15872,Elias of Kinninmonth (fl.1260-90),,M,1,0,1,1,0,1,73
3340,"Nicholas, abbot of Scone (fl.1270-73)",,M,1,0,1,1,0,1,73
3489,Chapel of St Nicholas of Lanark,,I,1,0,1,1,0,1,9
3496,"Church of St Kentigern, Lanark",,I,4,0,4,4,0,4,9
6949,"Cecilia, daughter of Earl Gilbert of Strathearn",,F,1,0,1,1,0,1,67
4873,Reginald del Bois,,M,1,0,1,1,0,1,71
4405,Thomas del Bois,,M,1,0,1,1,0,1,71
2423,"Abel of Gullane, bishop of St Andrews (d.1254)",,M,1,0,1,1,0,1,71
12729,Thomas of Liddell,,M,1,0,1,1,0,1,9
5114,Robert Mauleverer,,M,1,0,1,1,0,1,66
3668,"Henry de Sylton, prior of Coldingham (fl.1248-60)",,M,3,0,3,4,0,4,3
418,"Anketin, prior of Coldingham (fl.1235-42)",,M,2,0,2,2,0,2,3
12373,"Alexander, almoner of Coldingham ",,M,1,0,1,1,0,1,3
16018,"William, carpenter of Coldingham",,M,1,0,1,1,0,1,11
5441,"Ranulf, son of Aiulf of Mellerstain",,M,1,0,1,1,0,1,73
4864,Church of Kirkcaldy,,I,1,0,1,1,0,1,69
4865,Church of Dysart,,I,1,0,1,1,0,1,69
14399,"Richard of Liddell, nepos of Richard of Liddell",,M,1,0,1,1,0,1,12
13207,"Maurice, son of Robert, man of John son of Michael",,M,1,0,1,1,0,1,71
15853,"Thomas Vilator ",,M,1,0,1,1,0,1,1
11687,"Mark of Clapham, son of Hugh of Clapham",,M,1,0,1,1,0,1,13
9435,Chapel of Ogston,,I,1,0,1,1,0,1,14
4921,"Simon, deoradh, son of Thomas, deoradh, of Kinglassie",,M,1,0,1,1,0,1,15
3097,Richard Niger/Brun (12/13C),,M,1,0,1,1,0,1,3
2120,"Robert de Prebenda, bishop of Dunblane (d.1284)",,M,1,0,1,1,0,1,68
15179,Adam of Polwarth (father or son),,M,1,0,1,1,0,1,73
246,"Margaret, queen of Scots (d.1093)",,F,2,0,2,2,0,2,73
13288,"John of Maxton, son of Philip",,M,1,0,1,1,0,1,71
5552,"Nicholas, son of Brice (or the priest)",,M,2,0,2,2,0,2,68
10441,"Church of St Peter of Rathven ",,I,1,0,1,2,0,2,69
4468,Church of Dunballoch,,I,1,0,1,2,0,2,69
10445,Leper house of Rathven,,I,1,0,1,1,0,1,69
3584,Church of Old Kilpatrick,,I,2,0,2,2,0,2,66
15386,"John, son of Margaret wife of Michael Scott",,M,1,0,1,1,0,1,73
6993,"Mael Muire, son of Niall or Niallgus",,M,1,0,1,1,0,1,66
12225,Church of St DrostÄŹĹĽËťn of Insch,,I,1,0,1,2,0,2,16
5427,Matthew of Auchencrow,,M,1,0,1,1,0,1,0
4302,"Thomas, son of Ranulf (d. 1262)",,M,1,0,1,1,0,1,0
5426,Saint Bothan,,M,1,0,1,1,0,1,0
5391,St Bothans Priory,,I,1,0,1,1,0,1,0
4745,Walter Murray of Duffus (son of Hugh),,M,1,0,1,1,0,1,17
5270,Aberdeen Trinitarian Friary,,I,1,0,1,2,0,2,92
4924,"Richard Murray, son of Murdoch",,M,1,0,1,1,0,1,4
4957,"Simon Sturi, burgess of Musselburgh",,M,1,0,1,1,0,1,4
10810,"Robert, son of Adam Long of Hume",,M,1,0,1,2,0,2,73
5362,Brethren of Penitentia,,M,1,0,1,1,0,1,3
4961,Burgh of Dunfermline,,I,1,0,1,1,0,1,5
4960,Burgesses of Dunfermline,,M,1,0,1,1,0,1,5
2918,"Richard, son of John the priest",,M,1,0,1,1,0,1,18
5133,"William, son of P. of Speldemeloc",,M,1,0,1,1,0,1,19
5165,William Welyeuyth,,M,1,0,1,1,0,1,20
3694,"Roger, son of Martin the weaver",,M,1,0,1,1,0,1,21
22333,"Unknown, prior of Coldingham (13C)",,M,1,0,1,1,0,1,3
14115,"Elias, son of Aldan ",,M,1,0,1,1,0,1,3
3665,Patrick Scott of Reston (father of John Scott),,M,1,0,1,1,0,1,69
5430,Chapel of St Nicholas and St Mary of West Reston,,I,1,0,1,1,0,1,69
5436,"Adam of Twizel, almoner",,M,1,0,1,1,0,1,69
5435,"Nicholas of Ybernia, sacrist of Coldingham",,M,1,0,1,1,0,1,69
5437,"William of Darlington, terrar (Coldingham)",,M,1,0,1,1,0,1,69
7983,Simon of Badby,,M,1,0,1,1,0,1,22
11981,"Robert, son of Roger (brother of Adam of Edington) ",,M,1,0,1,1,0,1,3
5387,"Unknown, prioress of St Bothans",,F,1,0,1,1,0,1,3
13106,"Patrick, man of Simon Lindsay",,M,1,0,1,1,0,1,72
5866,Men of Melrose Abbey,,M,2,0,2,2,0,2,71
10837,Chapel of Wedderlie,,I,1,0,1,1,0,1,72
10710,Church of Greenlaw,,I,2,0,2,4,0,4,72
15900,"Juliana, daughter of Peter of Graden",,F,1,0,1,1,0,1,23
14140,"Alan, relative of Ness of London",,M,1,0,1,1,0,1,1
9658,Church of Gordon,,I,1,0,1,1,0,1,72
11682,"Archibald of Aberchirder, son of John",,M,1,0,1,1,0,1,24
3391,Church of St Andrew of Collessie,,I,1,0,1,1,0,1,25
6786,Church of St John in Kintyre,,I,1,0,1,1,0,1,66
12834,"Agnes, wife of David Graham",,F,2,0,2,2,0,2,66
4363,"William, bishop of Argyll (d.1241)",,M,1,0,1,1,0,1,6
6801,Church of Argyll,,I,1,0,1,1,0,1,6
8024,Hugh Mauleverer,,M,1,0,1,1,0,1,26
16936,"Murdoch, son of Corc",,M,2,0,2,3,0,3,2
7398,Friars Minor of Elgin,,I,1,0,1,1,0,1,69
11681,"Elizabeth, daughter of William Ramsay of Auchterhouse",,F,1,0,1,1,0,1,71
4444,"William Ramsay of Auchterhouse, sheriff of Forfar",,M,1,0,1,1,0,1,71
6147,"Adam, son of Cospatric (I) earl of Dunbar",,M,6,0,6,6,0,6,27
15839,Geoffrey of Haswell,,M,1,0,1,1,0,1,28
7969,Roger del Bernes of Auchencrow,,M,1,0,1,1,0,1,29
12109,"Stephen of Howden, sacrist of Coldingham",,M,2,0,2,2,0,2,3
1371,"Thomas I or II, prior of Coldingham",,M,1,0,1,1,0,1,30
6180,"Maurice, son of Master Merlin",,M,4,0,4,4,0,4,31
12488,Chapel of St Denis in Ayton,,I,1,0,1,1,0,1,32
5349,William Scott of Coldingham,,M,1,0,1,1,0,1,33
13609,Adam of Smardale,,M,1,0,1,1,0,1,9
11281,"Nicholas Sproull ",,M,2,0,2,2,0,2,7
8777,William Gley of Glasgow (late 12C),,M,1,0,1,1,0,1,34
2200,Abbey of St Thomas of Canterbury,,I,1,0,1,1,0,1,73
8971,Church of Cambusnethan,,I,1,0,1,1,0,1,72
12788,"John Erskine (II), son of John",,M,1,0,1,1,0,1,35
12537,"Richard, son of John of Invertiel ",,M,1,0,1,1,0,1,36
10571,"Michael, son of Morgan MacNab",,M,1,0,1,1,0,1,68
10544,"Unknown, chaplain of Mow",,M,1,0,1,1,0,1,72
3347,"Thomas Wallace, son of Adam Wallace",,M,3,0,3,4,0,4,48
10368,"Amabel, daughter of John of Ainslie, wife of John of Wemyss",,F,1,0,1,1,0,1,8
3301,"John of Wemyss, knight",,M,1,0,1,1,0,1,8
10381,"Christian, chaplain of St Marnan",,M,1,0,1,1,0,1,69
10576,"Nicholas Baird, son of Alexander Baird",,M,1,0,1,1,0,1,37
2069,"David of Haddington, son of Hugh White",,M,1,0,1,1,0,1,38
10594,Chaplains of Ingoliston (Kilbucho),,M,1,0,1,1,0,1,69
11200,Geoffrey of Eckford,,M,1,0,1,2,0,2,72
16832,Hugh de Ros (Rose),,M,1,0,1,2,0,2,69
16833,"Mariota/Mary, wife of Hugh de Ros (Rose)",,F,1,0,1,1,0,1,69
10742,Oliver of Brotherstone,,M,1,0,1,1,0,1,9
10864,Church of Wiston,,I,1,0,1,1,0,1,72
4044,"Constantine, abbot of Newbattle (1236)",,M,1,0,1,1,0,1,1
11086,"John, son of Robert the page",,M,2,0,2,2,0,2,39
4015,"Adam of Bathgate, master, sheriff of Roxburgh (d.1243)",,M,1,0,1,1,0,1,9
11638,"Mael Brigte Marrenah ",,M,1,0,1,1,0,1,40
12588,Chapel of Broughton,,I,1,0,1,1,0,1,66
5752,"Ada, wife of William Murray",,F,2,0,2,3,0,3,89
10431,"Adam, marischal of Seggie",,M,1,0,1,1,0,1,41
13484,Personas of Stobo,,M,1,0,1,1,0,1,1
12590,Church of Stobo,,I,1,0,1,1,0,1,1
6067,"Malcolm, son of Waltheof, clerk",,M,1,0,1,1,0,1,42
11644,"Duncan, son of Edward of Newtyle",,M,1,0,1,1,0,1,43
11614,David of Moncreiffe,,M,1,0,1,1,0,1,44
11651,"Alice, daughter of  Augustine ",,F,1,0,1,1,0,1,45
11696,"William Frereman ",,M,1,0,1,1,0,1,3
11807,"Geoffrey de Castro, cellarer of Coldingham ",,M,1,0,1,1,0,1,46
11004,John of Preston,,M,1,0,1,1,0,1,66
12168,"Robert Goscelin ",,M,1,0,1,1,0,1,47
8896,"Unknown, porter of Melrose",,M,5,0,5,6,0,6,69
1652,Rushen Abbey,,I,2,0,2,2,0,2,49
1254,"Reginald Crawford, sheriff of Ayr (early 13C)",,M,1,0,1,1,0,1,50
12827,"Michael Fleming, brother of Robert (ABD)",,M,1,0,1,1,0,1,51
12899,"Stephen, chaplain of Lamberton ",,M,1,0,1,1,0,1,52
14107,"Ness, son of William Ramsay (1267)",,M,1,0,1,1,0,1,53
12928,Thomas Melville of Temple,,M,1,0,1,1,0,1,1
12937,"Christiana, wife of Thomas Melville of Temple",,F,1,0,1,1,0,1,1
12984,"Eve, daughter of Thomas Melville, wife of Malcolm son of David",,F,1,0,1,1,0,1,1
12983,"Malcolm, son of David Dun",,M,1,0,1,1,0,1,1
12982,"Alice, daughter of Thomas Melville, wife of Richard son of Geoffrey",,F,1,0,1,1,0,1,1
12981,"Richard, son of Geoffrey son of Gunnhild",,M,1,0,1,1,0,1,1
12980,"Christiana, daughter of Thomas Melville, wife of Adam son of Walter",,F,1,0,1,1,0,1,1
12979,"Adam, son of Walter son of Aldwin",,M,1,0,1,1,0,1,1
10597,"Stephen Melville, clerk",,M,1,0,1,1,0,1,1
13402,"Hugh, brewer of Hassendean",,M,1,0,1,1,0,1,54
14486,John Hauewrth,,M,1,0,1,1,0,1,55
14573,Walter of Coldingham (brother of Gregory),,M,2,0,2,2,0,2,3
14848,Church of Bassendean,,I,1,0,1,1,0,1,72
2033,"Reginald of Irvine, archdeacon (d.1268)",,M,1,0,1,1,0,1,56
14999,"Henry Hastings, son of Albert of Dundee",,M,1,0,1,1,0,1,57
15153,Church of St Michael of Saltoun,,I,4,0,4,4,0,4,9
15096,Walter of Rossie (son of Thomas),,M,1,0,1,1,0,1,58
5703,"Thomas of Rossie, knight",,M,1,0,1,1,0,1,59
15360,Church of St Serf of Alva,,I,1,0,1,1,0,1,66
7731,Friars Preachers of Aberdeen,,I,1,0,1,1,0,1,60
15686,Walter Widowson,,M,2,0,2,2,0,2,61
15792,Waltheof Kokes,,M,1,0,1,1,0,1,62
15920,"Adam Purroc, citizen of St Andrews",,M,1,0,1,1,0,1,63
8472,Robert Grant (fl.1258),,M,1,0,1,1,0,1,64
16031,"Gilbert or Gilla Brigte of Glencarnie (IV), son of Gilbert (III)",,M,1,0,1,1,0,1,24
16945,"John, son of Michael, son of Eadwulf",,M,1,0,1,1,0,1,2
16947,"Forbflaith, wife of John son Michael son of Eadwulf",,F,1,0,1,1,0,1,2
17646,"James of Renfrew, chaplain",,M,1,0,1,2,0,2,65
